まいなす	-	感動詞	
かお	!(^^)!	名詞	
あんど	&	感動詞	
かっこ	()	感動詞	
かお	(*^_^*)	名詞	
えがお	(*^o^*)	名詞	
おこる	(*￣m￣)	名詞	
あせ	(..;)	名詞	
かお	(--;)	名詞	
あせ	(;ﾟロﾟ)	名詞	
わらい	(@^▽^@)	名詞	
かお	(^^;)	名詞	
わらう	(^▽^)	名詞	
かお	(^o^)	名詞	
かお	(~o~)	名詞	
なく	(T_T)	名詞	
びっくり	(ﾟДﾟ)	名詞	
かぶ	(株)	名詞	
ゆうげんがいしゃ	(有)	名詞	
こめ	*	名詞	
はてな	？	名詞	
_	＿	名詞	
DATE_FORMAT	{YEAR}{MONTH}{DATE}	名詞	
から	~	感動詞	
から	～	名詞	
からき	～キ	名詞サ変	
かっこ	｢｣	感動詞	
ぷらす	+	感動詞	
ばつか	×課	名詞	
まるまる	○○	名詞	
まるまるし	○○氏	名詞	
まるせる	●セル	名詞	
まるそーと	●ソート	名詞サ変	
まるいか	●以下	名詞	
まるいち	○一	数	
まるけん	○件	名詞	
まるふじ	○藤	名詞	
まるふじ	○不二	姓	
まるふじ	○不二	地名	
まるふじ	○不二	組織	
まるや	○也	名詞	
やそう	→そう	副詞	
ややね	→屋根	名詞	
やたてや	→建屋	名詞	
やすみ	→済み	名詞	
やかみ	→紙	名詞	
やゆか	→床	名詞	
やせい	→正	接頭語	
やそう	→相	名詞	
やかべ	→壁	名詞	
やな	→無	形容詞	
やよ	→良	形容詞	
ほしそーと	☆ソート	名詞サ変	
ほしそーと	★ソート	名詞サ変	
ちぇっく	☑	名詞	
ほし	✡	名詞	
こめこん	※コン	感動詞	
こめたまに	※たまに	副詞	
こめいか	※以下	名詞	
こめこうじ	※工事	名詞サ変	
こめず	※図	名詞	
こめさきほど	※先ほど	名詞	
こめた	※他	名詞	
こめたま	※多摩	姓	
こめたま	※多摩	地名	
こめよ	※良	形容詞	
まるじるし	〇印	名詞	
まるがつ	〇月	名詞	
いち	1	数	
いちにちいじょう	１日以上	名詞サ変	
に	2	数	
にい	2位	名詞	
にかい	2階	名詞	
にこうさくとう	２工作棟	名詞	
さん	3	数	
さんまい	3枚	名詞	
あ	a	名詞	
あ	Ａ	名詞	
あbc	ａｂｃ	名詞サ変	
あD	AD	名詞サ変	
あdhzm－22663	adhzm-22663	名詞サ変	
あどべ	adobe	名詞サ変	
ALC	ＡＬＣ	名詞サ変	
あな	ａｎａ	名詞サ変	
あっぷる	apple	名詞	
あとk	ａｔｏｋ	名詞サ変	
あう	ａｕ	名詞サ変	
おーと	auto	名詞	
b	b	名詞サ変	
b	B	名詞サ変	
BH	ＢＨ	名詞サ変	
びっと	bit	助数詞	
びっと	bit	名詞	
BOX	ＢＯＸ	名詞サ変	
c	C	名詞サ変	
c	Ｃ	名詞サ変	
chろめ	chrome	名詞サ変	
くらす	class	名詞	
せんちかく	㎝角	助数詞	
せんちかく	㎝角	名詞	
こっぁのt	collanot	名詞サ変	
cぴ	cpi	名詞サ変	
d	D	名詞サ変	
ぢm	ｄｉｍ	名詞サ変	
づえt	duet	名詞サ変	
EAF7	EAF7	名詞サ変	
えどx	edox	名詞サ変	
えんたー	Enter	名詞サ変	
えくせるや	Excel→	名詞	
えぃt	exit	名詞形動	
えやちょ	EYACHO	名詞サ変	
f	f	名詞サ変	
ふぁx	fax	名詞形動	
fkbc91	fkbc91	名詞サ変	
gびじd	gbizid	名詞サ変	
ごう	GO	名詞	
HDZ	HDZ	名詞サ変	
いf	if	名詞サ変	
jっw	ｊｗｗ	名詞サ変	
きのうの	Kinouno	名詞サ変	
KT	Kt	名詞サ変	
KT	KT	名詞サ変	
KT	ＫＴ	名詞サ変	
kう゛ぁ	KVA	名詞サ変	
KY	ＫＹ	名詞サ変	
りっとる	ℓ	名詞	
ぁん	ＬＡＮ	名詞形動	
LCS	LCS	名詞サ変	
LCS	ＬＣＳ	名詞サ変	
LCSぶ	LCS部	名詞	
lfbtrf30えf	Lfbtrf30ef	名詞サ変	
ろんぐ	long	名詞	
LSELV	LSELV	名詞サ変	
m	m	名詞サ変	
m	M	名詞サ変	
かお	m(_ _)m	名詞	
MAMORY	mamory	名詞サ変	
まっぷ	map	名詞	
MGCえーじれすかぶしきがいしゃ	ＭＧＣエージレスカブシキガイシャ	名詞サ変	
MGCふぃるしーとかぶしきがいしゃ	ＭＧＣフィルシートカブシキガイシャ	名詞サ変	
っm	ｍｍ	名詞サ変	
みりや	㎜→	名詞	
N3	Ｎ３	名詞サ変	
ねt	net	名詞サ変	
NET	ＮＥＴ	名詞サ変	
NTT	NTT	名詞サ変	
なんばーや	№→	名詞	
あどれす	odashima.eiji@ad-hzm.co.jp	名詞	
OKACON	ＯＫＡＣＯＮ	名詞サ変	
PCB	PCB	名詞サ変	
ふぉと	photo	名詞	
ぷらす	plus	名詞形動	
ぷろ	pro	名詞	
ぱいそん	python	名詞	
q	Q	名詞サ変	
q	Ｑ	名詞サ変	
QR	ＱＲ	名詞サ変	
QUあ	ＱＵａ	名詞サ変	
いらい	ＲＥＱＵＥＳＴ	名詞	
RN	RN	名詞サ変	
RN	ＲＮ	名詞サ変	
せいる	sale	名詞	
SAS	ＳＡＳ	名詞サ変	
sendai	SENDAI	名詞サ変	
すけっち	Sketch	名詞サ変	
SUBA	suba	名詞サ変	
suba	SUBA	名詞サ変	
t	t	名詞サ変	
TASK	ＴＡＳＫ	名詞サ変	
ちーむ	team	名詞	
てすと	testてすと	名詞	コメント
とっぷ	TOP	名詞	
TOPPANかぶしきがいしゃ	ＴＯＰＰＡＮカブシキガイシャ	名詞サ変	
UDとらっくすほっかいどうかぶしきがいしゃ	ＵＤトラックスホッカイドウカブシキガイシャ	名詞サ変	
あっぷ	Up	名詞サ変	
vば	vba	名詞サ変	
vs	ｖｓ	名詞サ変	
わてrまrk	watermark	名詞サ変	
うぇb	ｗｅｂ	名詞サ変	
うぃん	win	名詞形動	
をrkぼおk	workbook	名詞サ変	
z	Z	名詞サ変	
Z	Z	名詞サ変	
ぜん	ZEN	名詞	
あい・けい・けいかぶしきがいしゃ	アイ・ケイ・ケイカブシキガイシャ	名詞サ変	
あいえすえふねっと	アイエスエフネット	名詞サ変	
あいおいにっせい	アイオイニッセイ	名詞サ変	
あいおいにっせいどうわそんがいほけんかぶしきがいしゃ	アイオイニッセイドウワソンガイホケンカブシキガイシャ	名詞サ変	
あいおいにっせいどうわそんぽせんだいびる	アイオイニッセイドウワソンポセンダイビル	名詞サ変	
あいじー	ｱｲｼﾞｰ	組織	
あいづわかまつし	アイヅワカマツシ	名詞サ変	
あいぱっと	アイパット	名詞サ変	
あいりすおーやま	ｱｲﾘｽｵｰﾔﾏ	名詞サ変	
あおばく	アオバク	名詞サ変	
あおばく	あおばく	名詞サ変	
あおばくいちばんちょう	アオバクイチバンチョウ	名詞サ変	
あおばやまこんそーしあむ	アオバヤマコンソーシアム	名詞サ変	
あおもりけん	アオモリケン	名詞サ変	
あおもりけんひろさきしおおあざやましたちょう4－1	アオモリケンヒロサキシオオアザヤマシタチョウ４－１	名詞サ変	
あおもりし	アオモリシ	名詞サ変	
あおもりしつつみまち	アオモリシツツミマチ	名詞サ変	
あおやまいいん	アオヤマイイン	名詞サ変	
あき	アキ	名詞サ変	
あきうまちゆもと	アキウマチユモト	名詞サ変	
あきたけん	アキタケン	名詞サ変	
あきたけんあきたし	アキタケンアキタシ	名詞サ変	
あきたけんのしろし	アキタケンノシロシ	名詞サ変	
あきたし	アキタシ	名詞サ変	
あきたしなかどおり	アキタシナカドオリ	名詞サ変	
あきもく	アキモク	名詞サ変	
あきら	ｱｷﾗ	名詞サ変	
あきら	アキラ	名詞サ変	
あきら	あきら	名詞サ変	
あくしす	ｱｸｼｽ	名詞	
あくつ	アクツ	名詞サ変	
あくとす	アクトス	名詞サ変	
あくらす	アクラス	名詞サ変	
あくりるしりこん	ｱｸﾘﾙｼﾘｺﾝ	名詞サ変	
あくりるりしん	ｱｸﾘﾙﾘｼﾝ	名詞サ変	
あくりるりしん	アクリルリシン	名詞サ変	
あくりるりしんふき	アクリルリシン葺き	名詞	
あcろばt	アクロバット	名詞形動	
あげつま	アゲツマ	名詞サ変	
あげづま	アゲヅマ	名詞サ変	
あざ	アザ	名詞サ変	
あざあそざわ11ばんち1	アザアソザワ１１バンチ１	名詞サ変	
あざあらた77ばんち	アザアラタ７７バンチ	名詞サ変	
あざいしかみざわ34ばん1	アザイシカミザワ３４バン１	名詞サ変	
あざいっぽんまつ5ばんち1	アザイッポンマツ５バンチ１	名詞サ変	
あざうえはら27ばんちの2	アザウエハラ２７バンチノ２	名詞サ変	
あざおおもりやま	アザオオモリヤマ	名詞サ変	
あざおきづけ	アザオキヅケ	名詞サ変	
あざかいどうきた85ばんち	アザカイドウキタ８５バンチ	名詞サ変	
あざかがのさかい30ばんち	アザカガノサカイ３０バンチ	名詞サ変	
あざかしま	アザカシマ	名詞サ変	
あざさんのはら70－1	アザサンノハラ７０－１	名詞サ変	
あざしたかわらおき	アザシタカワラオキ	名詞サ変	
あざしんなみまつ4ばんち	アザシンナミマツ４バンチ	名詞サ変	
あざせんかりだ528ばんち1	アザセンカリダ５２８バンチ１	名詞サ変	
あざだいとく	アザダイトク	名詞サ変	
あざだとく	アザダトク	名詞サ変	
あざたなか8ばんち8	アザタナカ８バンチ８	名詞サ変	
あざてんしょうだん11ばんち	アザテンショウダン１１バンチ	名詞サ変	
あざどうのうしろ35ばんち	アザドウノウシロ３５バンチ	名詞サ変	
あざなかのばば1ばんちの1	アザナカノババ１バンチノ１	名詞サ変	
あざはたそい76－2	アザハタソイ７６－２	名詞サ変	
あざはら202ばんち	アザハラ２０２バンチ	名詞サ変	
あざひがしうら25－1	アザヒガシウラ２５－１	名詞サ変	
あざひがしとみえい1ばんち	アザヒガシトミエイ１バンチ	名詞サ変	
あさひぐるーぷえんじにありんぐかぶしきがいしゃ	アサヒグループエンジニアリングカブシキガイシャ	名詞サ変	
あさひでんきかぶしきがいしゃ	アサヒデンキカブシキガイシャ	名詞サ変	
あさひびーるかぶしきがいしゃ	アサヒビールカブシキガイシャ	名詞サ変	
あさひふどうさんかんりかぶしきがいしゃ	アサヒフドウサンカンリカブシキガイシャ	名詞サ変	
あざぶくでん99ばんち	アザブクデン９９バンチ	名詞サ変	
あざまちむかい	アザマチムカイ	名詞サ変	
あざみなみざか920ばんち	アザミナミザカ９２０バンチ	名詞サ変	
あざむかいはらまえ6ばん2ごう	アザムカイハラマエ６バン２ゴウ	名詞サ変	
あざめい	ｱｻﾞﾒｲ	名詞サ変	
あざもとかしま145ばんち	アザモトカシマ１４５バンチ	名詞サ変	
あざやはた608ばんち	アザヤハタ６０８バンチ	名詞サ変	
あざやまのかみ53ばんちの4	アザヤマノカミ５３バンチノ４	名詞サ変	
あしながいくえいかい	アシナガイクエイカイ	名詞サ変	
あすきゃっち	アスキャッチ	名詞サ変	
あすくる	アスクル	名詞サ変	
あすとも	アストモ	名詞サ変	
あすふぁると	ｱｽﾌｧﾙﾄ	名詞	
あすべすと	ｱｽﾍﾞｽﾄ	名詞	
あすべにや	アスベニヤ	名詞サ変	
あずまばし	アズマバシ	名詞サ変	
あすろっく	アスロック	名詞サ変	
あそるてぃ	アソルティ	名詞サ変	
あつろう	アツロウ	名詞サ変	
あどれす	あどれす	名詞サ変	
あなふーずかぶしきがいしゃ	アナフーズカブシキガイシャ	名詞サ変	
あぱれる	ｱﾊﾟﾚﾙ	名詞	
あまの	アマノ	名詞サ変	
あやね	ｱﾔﾈ	名詞サ変	
あらお	アラオ	名詞サ変	
ありあけ	アリアケ	名詞サ変	
あるみ	ｱﾙﾐ	名詞	
あるます	ある桝	名詞	
あれす	ｱﾚｽ	人名	
あれすえこくりーん	ｱﾚｽｴｺｸﾘｰﾝ	名詞サ変	
あれすだいなみっく	ｱﾚｽﾀﾞｲﾅﾐｯｸ	名詞サ変	
あれすだいなみっく	アレスダイナミック	名詞サ変	
あれすほるだー	ｱﾚｽﾎﾙﾀﾞｰ	名詞サ変	
あればですが	あればですが	名詞サ変	
あんかー	ｱﾝｶｰ	名詞	
あんずわかいいまむらほーむくりにっく	アンズワカイイマムラホームクリニック	名詞サ変	
あんてな	ｱﾝﾃﾅ	名詞サ変	
あんどう	ｱﾝﾄﾞｳ	名詞サ変	
あんどう	アンドウ	名詞サ変	
あんどう・はざま	ｱﾝﾄﾞｳ･ﾊｻﾞﾏ	名詞サ変	
あんどう・はざま	アンドウ・ハザマ	名詞サ変	
あんどうはざま	アンドウハザマ	名詞サ変	
あんどうはざまげんばじむしょ	アンドウハザマゲンバジムショ	名詞サ変	
あんみん	アンミン	名詞サ変	
いいん	イイン	名詞サ変	
いおんくれじっとさーびすかぶしきがいしゃ	イオンクレジットサービスカブシキガイシャ	名詞サ変	
いがわまち	いがわまち	名詞サ変	
いしかわ	ｲｼｶﾜ	名詞サ変	
いしづか2ちょうめ16ばんち3	イシヅカ２チョウメ１６バンチ３	名詞サ変	
いずみ	いずみ	名詞サ変	
いずみかい	いずみ会	名詞	
いすむ	イスム	名詞サ変	
ぃた	ィタ	名詞サ変	
いちの	イチノ	名	
いちばんちょう	イチバンチョウ	名詞サ変	
いっぱんざいだんほうじんおおたそうごうびょういん	イッパンザイダンホウジンオオタソウゴウビョウイン	名詞サ変	
いっぱんざいだんほうじんこうせいかい	イッパンザイダンホウジンコウセイカイ	名詞サ変	
いっぱんざいだんほうじんじざんかいいがくけんきゅう	イッパンザイダンホウジンジザンカイイガクケンキュウ	名詞サ変	
いっぱんざいだんほうじんとうほくせいしんほけんかい	イッパンザイダンホウジントウホクセイシンホケンカイ	名詞サ変	
いっぱんざいだんほうじんのうしんけいしっかんけんきゅうし	イッパンザイダンホウジンノウシンケイシッカンケンキュウシ	名詞サ変	
いっぱんざいだんほうじんやまがたけんきょういくかいかん	イッパンザイダンホウジンヤマガタケンキョウイクカイカン	名詞サ変	
いっぱんしゃだんほうじんいわてけんやくざいしかい	イッパンシャダンホウジンイワテケンヤクザイシカイ	名詞サ変	
いっぱんしゃだんほうじんさどううらせんけだんいたるかい	イッパンシャダンホウジンサドウウラセンケダンイタルカイ	名詞サ変	
いっぱんしゃだんほうじんまちづくりなみえ	イッパンシャダンホウジンマチヅクリナミエ	名詞サ変	
いとう	イトウ	名詞サ変	
いとう	いとう	名詞サ変	
いとむか	イトムカ	名詞サ変	
いはらけんせいこうぎょうかぶしきがいしゃ	イハラケンセイコウギョウカブシキガイシャ	名詞サ変	
いむす	イムス	名詞サ変	
いりょうほうじん	イリョウホウジン	名詞サ変	
いりょうほうじんあおやまいいん	イリョウホウジンアオヤマイイン	名詞サ変	
いりょうほうじんおおだかないかいちょうか	イリョウホウジンオオダカナイカイチョウカ	名詞サ変	
いりょうほうじんかいとかい	イリョウホウジンカイトカイ	名詞サ変	
いりょうほうじんけいあいかい	イリョウホウジンケイアイカイ	名詞サ変	
いりょうほうじんこみねかい	イリョウホウジンコミネカイ	名詞サ変	
いりょうほうじんざいだんあかりかい	イリョウホウジンザイダンアカリカイ	名詞サ変	
いりょうほうじんざいだんごりんかい	イリョウホウジンザイダンゴリンカイ	名詞サ変	
いりょうほうじんしゃだんあきひろかい	イリョウホウジンシャダンアキヒロカイ	名詞サ変	
いりょうほうじんしゃだんじゅんかみあい	イリョウホウジンシャダンジュンカミアイ	名詞サ変	
いりょうほうじんしゃだんやぎゅうよしだこどもくりにっく	イリョウホウジンシャダンヤギュウヨシダコドモクリニック	名詞サ変	
いりょうほうじんしゃだんやすなりかい	イリョウホウジンシャダンヤスナリカイ	名詞サ変	
いりょうほうじんじょうじんかい	イリョウホウジンジョウジンカイ	名詞サ変	
いりょうほうじんつかもとないかしょうかきか	イリョウホウジンツカモトナイカショウカキカ	名詞サ変	
いりょうほうじんとおやまびょういん	イリョウホウジントオヤマビョウイン	名詞サ変	
いりょうほうじんななごうくりにっく	イリョウホウジンナナゴウクリニック	名詞サ変	
いりょうほうじんめいようあいおうみせいけいげか	イリョウホウジンメイヨウアイオウミセイケイゲカ	名詞サ変	
いれぶん	ｲﾚﾌﾞﾝ	名詞	
いわおあきらさとし	イワオアキラサトシ	名詞サ変	
いわてけん	イワテケン	名詞サ変	
いわてけんいさわぐんかねがさきちょう	イワテケンイサワグンカネガサキチョウ	名詞サ変	
いわてけんおうしゅうし	イワテケンオウシュウシ	名詞サ変	
いわてけんしょうぼうちょうかい	イワテケンショウボウチョウカイ	名詞サ変	
いわてこうじょう	イワテコウジョウ	名詞サ変	
いんこうか	インコウカ	名詞サ変	
いんさーくる	インサークル	名詞サ変	
いんしゅろっく	インシュロック	名詞サ変	
いんてくす	インテクス	名詞サ変	
いんとらない	イントラ内	名詞	
いんぱくとしよう	インパクト使用	名詞サ変	
いんぱくととう	インパクト等	名詞	
いんふら	ｲﾝﾌﾗ	名詞	
いんふらはそん	インフラ破損	名詞サ変	
ういんど	ｳｲﾝﾄﾞ	名詞	
ういんどう	ｳｲﾝﾄﾞｳ	名詞	
うおーきんぐくろーぜっと	ｳｵｰｷﾝｸﾞｸﾛｰｾﾞｯﾄ	名詞サ変	
うぉーたーさーばー	ｳｫｰﾀｰｻｰﾊﾞｰ	名詞サ変	
うおーる	ｳｵｰﾙ	名詞サ変	
うおっしゅ	ｳｵｯｼｭ	名詞サ変	
うおるぼっくす	ウオルボックス	名詞サ変	
うじいえてるひこ	ウジイエテルヒコ	名詞サ変	
うちじょう	ウチジョウ	名詞サ変	
うちだ	ｳﾁﾀﾞ	名詞サ変	
うつみけいこ	ウツミケイコ	名詞サ変	
うんどう	ウンドウ	名詞サ変	
えあこん	ｴｱｺﾝ	名詞	
えあはん	エアハン	名詞サ変	
えいあいじーそんがいほけんかぶしきがいしゃ	エイアイジーソンガイホケンカブシキガイシャ	名詞サ変	
えいいち	エイイチ	名詞サ変	
えいきち	エイキチ	名詞サ変	
えいじ	エイジ	名詞サ変	
えいわん	エイワン	名詞サ変	
えー	エー	名詞サ変	
えきすぱんどめたる	ｴｷｽﾊﾟﾝﾄﾞﾒﾀﾙ	名詞サ変	
えきなん3－11－2	エキナン３－１１－２	名詞サ変	
えす・おー・しーかぶしきがいしゃ	エス・オー・シーカブシキガイシャ	名詞サ変	
えす・けー・しー・てくの	ｴｽ･ｹｰ･ｼｰ･ﾃｸﾉ	名詞サ変	
えすいー	ｴｽｲｰ	組織	
えすけーえんじにありんぐ	ｴｽｹｰｴﾝｼﾞﾆｱﾘﾝｸﾞ	名詞サ変	
えすじーあーる	エスジーアール	名詞サ変	
えすぴー	ｴｽﾋﾟｰ	名詞サ変	
えでったー	エデッター	名詞サ変	
えぬいーしーふぁしりてぃーずかぶしきがいしゃ	エヌイーシーファシリティーズカブシキガイシャ	名詞サ変	
えぽ	エポ	名詞サ変	
えむけーだくと	ｴﾑｹｰﾀﾞｸﾄ	名詞サ変	
えむけーだくとしろ	ｴﾑｹｰﾀﾞｸﾄ白	名詞	
えらーら	エラーラ	名詞サ変	
えらーじ	エラー時	名詞	
えるでぃ	エルディ	名詞サ変	
えんじ	エンジ	名詞サ変	
おう	オウ	名詞サ変	
おうぎだ	オウギダ	名詞サ変	
おおあざ	オオアザ	名詞サ変	
おおうち	オオウチ	名詞サ変	
おおえどおんせんものがたりかぶしきがいしゃ	オオエドオンセンモノガタリカブシキガイシャ	名詞サ変	
おおかじ	オオカジ	名詞サ変	
おおぎだ	オオギダ	名詞サ変	
おおこううんそうかぶしきがいしゃ	オオコウウンソウカブシキガイシャ	名詞サ変	
おおすみ	オオスミ	名詞サ変	
おおそえ52ばんち1	オオソエ５２バンチ１	名詞サ変	
おおたかさだお	オオタカサダオ	名詞サ変	
おおたけ	オオタケ	名詞サ変	
おーたすかり	オータスカリ	名詞サ変	
おおだすかり	オオダスカリ	名詞サ変	
おおたびる	オオタビル	名詞サ変	
おおたよしお	オオタヨシオ	名詞サ変	
おおつさんぎょう	オオツサンギョウ	名詞サ変	
おおてまち	オオテマチ	名詞サ変	
おーなー	ｵｰﾅｰ	名詞	
おーばーふろー	ｵｰﾊﾞｰﾌﾛｰ	名詞サ変	
おーばーれい	ｵｰﾊﾞｰﾚｲ	名詞サ変	
おおまち	オオマチ	名詞サ変	
おおもり	おおもり	名詞サ変	
おーりんくかぶしきがいしゃ	オーリンクカブシキガイシャ	名詞サ変	
おーるてれーんくれーん	ｵｰﾙﾃﾚｰﾝｸﾚｰﾝ	名詞サ変	
おかこん	オカコン	名詞サ変	
おきづけ4ばんち108	オキヅケ４バンチ１０８	名詞サ変	
おくせ	オクセ	名詞サ変	
おぐら	オグラ	名詞サ変	
おそうじほんぽひがしね	オソウジホンポヒガシネ	名詞サ変	
おだかく	オダカク	名詞サ変	
おだしま	ｵﾀﾞｼﾏ	名詞サ変	
おだしま	オダシマ	名詞サ変	
おだしまえいじ	ｵﾀﾞｼﾏｴｲｼﾞ	名詞サ変	
おだしまえいじ	オダシマエイジ	名詞サ変	
おにづか	オニヅカ	名詞サ変	
おねすと	ｵﾈｽﾄ	名詞サ変	
おふせっと	ｵﾌｾｯﾄ	名詞サ変	
おぶち	オブチ	名詞サ変	
おみやげだい	おみやげ代	名詞	
おりっくす・ほてるまねじめんとかぶしきがいしゃ	オリックス・ホテルマネジメントカブシキガイシャ	名詞サ変	
おりぱら	オリパラ	名詞サ変	
おるたっく	オルタック	名詞サ変	
おれんじせん	オレンジ線	名詞	
おんわーどぱーくびるでぃんぐ13F・14F	オンワードパークビルディング１３Ｆ・１４Ｆ	名詞サ変	
おすすめど	お勧め度	名詞	
おなおり	お直り	名詞	
かーすとっぱー	ｶｰｽﾄｯﾊﾟｰ	名詞サ変	
かーてん	ｶｰﾃﾝ	名詞	
かーど	ｶｰﾄﾞ	名詞	
がーどまん	ｶﾞｰﾄﾞﾏﾝ	名詞	
かーどとう	ｶｰﾄﾞ等	名詞	
かーぶみらー	ｶｰﾌﾞﾐﾗｰ	名詞サ変	
かーぶみらー	カーブミラー	名詞サ変	
かーぺっと	ｶｰﾍﾟｯﾄ	名詞	
かい	カイ	名詞サ変	
がいいのでしょうか	がいいのでしょうか	名詞サ変	
かいかん	カイカン	名詞サ変	
かいがん24ばん9	カイガン２４バン９	名詞サ変	
かいぜないかくりにっく	カイゼナイカクリニック	名詞サ変	
かいてるっぽい	カイテルッポイ	名詞サ変	
かいばらしんばやし3008ばんち	カイバラシンバヤシ３００８バンチ	名詞サ変	
かうんたー	ｶｳﾝﾀｰ	名詞	
かがのさかい30	ｶｶﾞﾉｻｶｲ30	名詞サ変	
かき	カキ	名詞サ変	
がくえん	ガクエン	名詞サ変	
かごない	カゴ内	名詞	
かしまたてものそうごうかんりかぶしきがいしゃ	カシマタテモノソウゴウカンリカブシキガイシャ	名詞サ変	
がす	ｶﾞｽ	名詞	
かすみちょう	カスミチョウ	名詞サ変	
かずや	かずや	名詞サ変	
がたつき	ガタツキ	名詞サ変	
かたひら	ｶﾀﾋﾗ	名詞サ変	
かたひら	カタヒラ	名詞サ変	
かたろぐや	カタログ→	名詞	
がっこうほうじんこばとがくえん	ガッコウホウジンコバトガクエン	名詞サ変	
がっこうほうじんさんこうがくえん	ガッコウホウジンサンコウガクエン	名詞サ変	
がっこうほうじんせいわがくえん	ガッコウホウジンセイワガクエン	名詞サ変	
がっこうほうじんそうしがくえん	ガッコウホウジンソウシガクエン	名詞サ変	
がっこうほうじんとうほくげいじゅつこうかだいがく	ガッコウホウジントウホクゲイジュツコウカダイガク	名詞サ変	
がっこうほうじんにほんだいがく	ガッコウホウジンニホンダイガク	名詞サ変	
がっさんじうしろ18ばんちの3	ガッサンジウシロ１８バンチノ３	名詞サ変	
かっと	ｶｯﾄ	名詞サ変	
かつもと	カツモト	名詞サ変	
かつゆき	かつゆき	名詞サ変	
かと	かと	名詞サ変	
かとりっくこおりやまきょうかい	カトリックコオリヤマキョウカイ	名詞サ変	
かなてっく	カナテック	名詞サ変	
かねさぷらんにんぐかぶしきがいしゃ	カネサプランニングカブシキガイシャ	名詞サ変	
かねてく	かねて来	動詞カ変	
かねひら	カネヒラ	名詞サ変	
かねふじれいぞうかぶしきがいしゃ	カネフジレイゾウカブシキガイシャ	名詞サ変	
がばっとふぁいる	ガバットファイル	名詞サ変	
かぶしきがいしゃ	カブシキガイシャ	名詞サ変	
かぶしきがいしゃRばんく	カブシキガイシャＲバンク	名詞サ変	
かぶしきがいしゃYCCじょうほうしすてむ	カブシキガイシャＹＣＣジョウホウシステム	名詞サ変	
かぶしきがいしゃあいえすえふねっと	カブシキガイシャアイエスエフネット	名詞サ変	
かぶしきがいしゃあいんふぁーましーず	カブシキガイシャアインファーマシーズ	名詞サ変	
かぶしきがいしゃあきたぎんこう	カブシキガイシャアキタギンコウ	名詞サ変	
かぶしきがいしゃあさひしんぶんしゃ	カブシキガイシャアサヒシンブンシャ	名詞サ変	
かぶしきがいしゃあでか	カブシキガイシャアデカ	名詞サ変	
かぶしきがいしゃあべほーみんぐ	カブシキガイシャアベホーミング	名詞サ変	
かぶしきがいしゃあんどう・はざま	ｶﾌﾞｼｷｶﾞｲｼｬｱﾝﾄﾞｳ･ﾊｻﾞﾏ	名詞サ変	
かぶしきがいしゃあんない	カブシキガイシャアンナイ	名詞サ変	
かぶしきがいしゃいーおん	カブシキガイシャイーオン	名詞サ変	
かぶしきがいしゃいこいじゅうせつ	カブシキガイシャイコイジュウセツ	名詞サ変	
かぶしきがいしゃいずみてくの	カブシキガイシャイズミテクノ	名詞サ変	
かぶしきがいしゃいちりきりょかん	カブシキガイシャイチリキリョカン	名詞サ変	
かぶしきがいしゃいのう゛ぁんす	カブシキガイシャイノヴァンス	名詞サ変	
かぶしきがいしゃいりふくふくたしょうてん	カブシキガイシャイリフクフクタショウテン	名詞サ変	
かぶしきがいしゃいわてにっぽうしゃ	カブシキガイシャイワテニッポウシャ	名詞サ変	
かぶしきがいしゃいわぶちざいもくてん	カブシキガイシャイワブチザイモクテン	名詞サ変	
かぶしきがいしゃうちだ	カブシキガイシャウチダ	名詞サ変	
かぶしきがいしゃえぬじぇいあい	カブシキガイシャエヌジェイアイ	名詞サ変	
かぶしきがいしゃえふこむ	カブシキガイシャエフコム	名詞サ変	
かぶしきがいしゃえむじーふぁしりてぃーず	カブシキガイシャエムジーファシリティーズ	名詞サ変	
かぶしきがいしゃえるでぃ	カブシキガイシャエルディ	名詞サ変	
かぶしきがいしゃおおためでぃかるしょっぷ	カブシキガイシャオオタメディカルショップ	名詞サ変	
かぶしきがいしゃおおとももっこうしょ	カブシキガイシャオオトモモッコウショ	名詞サ変	
かぶしきがいしゃおーむでんき	カブシキガイシャオームデンキ	名詞サ変	
かぶしきがいしゃかねさふじわらや	カブシキガイシャカネサフジワラヤ	名詞サ変	
かぶしきがいしゃかわいじゅくまなびす	カブシキガイシャカワイジュクマナビス	名詞サ変	
かぶしきがいしゃかわきたしんぽうしゃ	カブシキガイシャカワキタシンポウシャ	名詞サ変	
かぶしきがいしゃかんぽせいめいほけん	カブシキガイシャカンポセイメイホケン	名詞サ変	
かぶしきがいしゃきたにほんぎんこう	カブシキガイシャキタニホンギンコウ	名詞サ変	
かぶしきがいしゃきむらや	カブシキガイシャキムラヤ	名詞サ変	
かぶしきがいしゃきょくちょうとがししょうてん	カブシキガイシャキョクチョウトガシショウテン	名詞サ変	
かぶしきがいしゃぐっどういん	カブシキガイシャグッドウイン	名詞サ変	
かぶしきがいしゃくらば	カブシキガイシャクラバ	名詞サ変	
かぶしきがいしゃぐらんべるほてる	カブシキガイシャグランベルホテル	名詞サ変	
かぶしきがいしゃげんしょうてん	カブシキガイシャゲンショウテン	名詞サ変	
かぶしきがいしゃこーあ	カブシキガイシャコーア	名詞サ変	
かぶしきがいしゃこがたしょうてん	カブシキガイシャコガタショウテン	名詞サ変	
かぶしきがいしゃこめり	カブシキガイシャコメリ	名詞サ変	
かぶしきがいしゃさんけいびる	カブシキガイシャサンケイビル	名詞サ変	
かぶしきがいしゃしぐまこみゅにてぃ	カブシキガイシャシグマコミュニティ	名詞サ変	
かぶしきがいしゃしばたいんてっく	カブシキガイシャシバタインテック	名詞サ変	
かぶしきがいしゃじゅらく	カブシキガイシャジュラク	名詞サ変	
かぶしきがいしゃしんわ	カブシキガイシャシンワ	名詞サ変	
かぶしきがいしゃしんわほーるでぃんぐす	カブシキガイシャシンワホールディングス	名詞サ変	
かぶしきがいしゃすがお	カブシキガイシャスガオ	名詞サ変	
かぶしきがいしゃすずきがっきせいさくしょ	カブシキガイシャスズキガッキセイサクショ	名詞サ変	
かぶしきがいしゃせんじゅほーるでぃんぐす	カブシキガイシャセンジュホールディングス	名詞サ変	
かぶしきがいしゃせんだいきしょう	カブシキガイシャセンダイキショウ	名詞サ変	
かぶしきがいしゃせんだいびるでぃんぐ	カブシキガイシャセンダイビルディング	名詞サ変	
かぶしきがいしゃせんぱーくたうんさーびす	カブシキガイシャセンパークタウンサービス	名詞サ変	
かぶしきがいしゃそうてつほてるかいはつ	カブシキガイシャソウテツホテルカイハツ	名詞サ変	
かぶしきがいしゃそーわだいれくと	カブシキガイシャソーワダイレクト	名詞サ変	
かぶしきがいしゃそふと99こーぽれーしょん	カブシキガイシャソフト９９コーポレーション	名詞サ変	
かぶしきがいしゃだいひさしせいめん	カブシキガイシャダイヒサシセイメン	名詞サ変	
かぶしきがいしゃたくま	カブシキガイシャタクマ	名詞サ変	
かぶしきがいしゃたけだしょうてん	カブシキガイシャタケダショウテン	名詞サ変	
かぶしきがいしゃたけもり	カブシキガイシャタケモリ	名詞サ変	
かぶしきがいしゃだすきん	カブシキガイシャダスキン	名詞サ変	
かぶしきがいしゃたまざわそうほんてん	カブシキガイシャタマザワソウホンテン	名詞サ変	
かぶしきがいしゃたまのや	カブシキガイシャタマノヤ	名詞サ変	
かぶしきがいしゃちゅうおうじゅうたくさんぎょう	カブシキガイシャチュウオウジュウタクサンギョウ	名詞サ変	
かぶしきがいしゃちんたい	カブシキガイシャチンタイ	名詞サ変	
かぶしきがいしゃつがわ	カブシキガイシャツガワ	名詞サ変	
かぶしきがいしゃでぃあーず・ぶれいん	カブシキガイシャディアーズ・ブレイン	名詞サ変	
かぶしきがいしゃてれびゆーふくしま	カブシキガイシャテレビユーフクシマ	名詞サ変	
かぶしきがいしゃでんろく	カブシキガイシャデンロク	名詞サ変	
かぶしきがいしゃとうきゅうえーじぇんしー	カブシキガイシャトウキュウエージェンシー	名詞サ変	
かぶしきがいしゃとうほうぎんこう	カブシキガイシャトウホウギンコウ	名詞サ変	
かぶしきがいしゃとうほくぎんこう	カブシキガイシャトウホクギンコウ	名詞サ変	
かぶしきがいしゃとうほくてれねっと	カブシキガイシャトウホクテレネット	名詞サ変	
かぶしきがいしゃとうほくどう	カブシキガイシャトウホクドウ	名詞サ変	
かぶしきがいしゃとうほくまるわろじすてぃくす	カブシキガイシャトウホクマルワロジスティクス	名詞サ変	
かぶしきがいしゃどうまたとけいてん	カブシキガイシャドウマタトケイテン	名詞サ変	
かぶしきがいしゃとっぱんいんふぉめでぃあ	カブシキガイシャトッパンインフォメディア	名詞サ変	
かぶしきがいしゃとみひろ	カブシキガイシャトミヒロ	名詞サ変	
かぶしきがいしゃななじゅうななかーど	カブシキガイシャナナジュウナナカード	名詞サ変	
かぶしきがいしゃななじゅうななぎんこう	カブシキガイシャナナジュウナナギンコウ	名詞サ変	
かぶしきがいしゃにちいがっかん	カブシキガイシャニチイガッカン	名詞サ変	
かぶしきがいしゃにっせーでりか	カブシキガイシャニッセーデリカ	名詞サ変	
かぶしきがいしゃにほんあくあ	カブシキガイシャニホンアクア	名詞サ変	
かぶしきがいしゃにほんぱーそなるびじねす	カブシキガイシャニホンパーソナルビジネス	名詞サ変	
かぶしきがいしゃぬのめ	カブシキガイシャヌノメ	名詞サ変	
かぶしきがいしゃばいたるねっと	カブシキガイシャバイタルネット	名詞サ変	
かぶしきがいしゃはちぜんどう	カブシキガイシャハチゼンドウ	名詞サ変	
かぶしきがいしゃはなわ	カブシキガイシャハナワ	名詞サ変	
かぶしきがいしゃはまなこーぽれーしょん	カブシキガイシャハマナコーポレーション	名詞サ変	
かぶしきがいしゃはやさかさいくるしょうかい	カブシキガイシャハヤサカサイクルショウカイ	名詞サ変	
かぶしきがいしゃはやま	カブシキガイシャハヤマ	名詞サ変	
かぶしきがいしゃばんざい	カブシキガイシャバンザイ	名詞サ変	
かぶしきがいしゃひがししょえすてーと	カブシキガイシャヒガシショエステート	名詞サ変	
かぶしきがいしゃひがしねしんでんげん	カブシキガイシャヒガシネシンデンゲン	名詞サ変	
かぶしきがいしゃひたちぷらんとさーびす	カブシキガイシャヒタチプラントサービス	名詞サ変	
かぶしきがいしゃふぁーすと	カブシキガイシャファースト	名詞サ変	
かぶしきがいしゃふくしまほうそう	カブシキガイシャフクシマホウソウ	名詞サ変	
かぶしきがいしゃふくしまみんぽうかいかん	カブシキガイシャフクシマミンポウカイカン	名詞サ変	
かぶしきがいしゃふくしまみんぽうしゃ	カブシキガイシャフクシマミンポウシャ	名詞サ変	
かぶしきがいしゃふくだ・あんど・ぱーとなーず	カブシキガイシャフクダ・アンド・パートナーズ	名詞サ変	
かぶしきがいしゃふじくら・だいやけーぶる	カブシキガイシャフジクラ・ダイヤケーブル	名詞サ変	
かぶしきがいしゃふじさき	カブシキガイシャフジサキ	名詞サ変	
かぶしきがいしゃふじつうぜねらる	カブシキガイシャフジツウゼネラル	名詞サ変	
かぶしきがいしゃふじつうぜねらるえれくとろにくす	カブシキガイシャフジツウゼネラルエレクトロニクス	名詞サ変	
かぶしきがいしゃぷれあーく	カブシキガイシャプレアーク	名詞サ変	
かぶしきがいしゃふれあいけあさーびすはーどでぃすく	カブシキガイシャフレアイケアサービスハードディスク	名詞サ変	
かぶしきがいしゃべるじょいす	カブシキガイシャベルジョイス	名詞サ変	
かぶしきがいしゃほんだよんりんはんばいほっかいどう	カブシキガイシャホンダヨンリンハンバイホッカイドウ	名詞サ変	
かぶしきがいしゃほんだろじすてぃくす	カブシキガイシャホンダロジスティクス	名詞サ変	
かぶしきがいしゃまてっく	カブシキガイシャマテック	名詞サ変	
かぶしきがいしゃまるじましょうじ	カブシキガイシャマルジマショウジ	名詞サ変	
かぶしきがいしゃまるたま	カブシキガイシャマルタマ	名詞サ変	
かぶしきがいしゃまるばん	カブシキガイシャマルバン	名詞サ変	
かぶしきがいしゃまるひろしうんそう	カブシキガイシャマルヒロシウンソウ	名詞サ変	
かぶしきがいしゃみはらどう	カブシキガイシャミハラドウ	名詞サ変	
かぶしきがいしゃみやこあいん	カブシキガイシャミヤコアイン	名詞サ変	
かぶしきがいしゃむらた	カブシキガイシャムラタ	名詞サ変	
かぶしきがいしゃめいほう	カブシキガイシャメイホウ	名詞サ変	
かぶしきがいしゃめでぃかるねっと	カブシキガイシャメディカルネット	名詞サ変	
かぶしきがいしゃめにこん	カブシキガイシャメニコン	名詞サ変	
かぶしきがいしゃもーど・あらいぶ	カブシキガイシャモード・アライブ	名詞サ変	
かぶしきがいしゃもりおかえきまえびる	カブシキガイシャモリオカエキマエビル	名詞サ変	
かぶしきがいしゃもりおかそうごうびるめんてなんす	カブシキガイシャモリオカソウゴウビルメンテナンス	名詞サ変	
かぶしきがいしゃもんくれーるじゃぱん	カブシキガイシャモンクレールジャパン	名詞サ変	
かぶしきがいしゃやまがたしんぶんしゃ	カブシキガイシャヤマガタシンブンシャ	名詞サ変	
かぶしきがいしゃやまざわ	カブシキガイシャヤマザワ	名詞サ変	
かぶしきがいしゃやましょく	カブシキガイシャヤマショク	名詞サ変	
かぶしきがいしゃゆあてっく	カブシキガイシャユアテック	名詞サ変	
かぶしきがいしゃゆたかづき	カブシキガイシャユタカヅキ	名詞サ変	
かぶしきがいしゃらいずえきすぷれす	カブシキガイシャライズエキスプレス	名詞サ変	
かぶしきがいしゃらじおふくしま	カブシキガイシャラジオフクシマ	名詞サ変	
かぶしきがいしゃりょくすいてい	カブシキガイシャリョクスイテイ	名詞サ変	
かぶしきがいしゃろいやるこすめてぃっくす	カブシキガイシャロイヤルコスメティックス	名詞サ変	
かぶしきがいしゃわいずうぃるまねじめんと	カブシキガイシャワイズウィルマネジメント	名詞サ変	
かまた	ｶﾏﾀ	名詞サ変	
かまた	カマタ	名詞サ変	
かみきたぐん	カミキタグン	名詞サ変	
かみどう	カミドウ	名詞サ変	
かみはら	カミハラ	名詞サ変	
かめい	カメイ	名詞サ変	
かやましょうにかいいん	カヤマショウニカイイン	名詞サ変	
がらーがるばりうむ	ガラーガルバリウム	名詞サ変	
からーこーん	ｶﾗｰｺｰﾝ	固有名詞	
がらす	ｶﾞﾗｽ	名詞	
からぱごす	カラパゴス	名詞サ変	
からむめい	カラム名	助数詞	
からむめい	カラム名	名詞	
がらり	ｶﾞﾗﾘ	感動詞	
がらとう	ガラ等	接尾一般	
かりたそうごうびょういん	カリタソウゴウビョウイン	名詞サ変	
がるばりうむ	ｶﾞﾙﾊﾞﾘｳﾑ	固有名詞	
かわきたけんせつかぶしきがいしゃ	カワキタケンセツカブシキガイシャ	名詞サ変	
かわむらでんきさんぎょうかぶしきがいしゃ	カワムラデンキサンギョウカブシキガイシャ	名詞サ変	
かんげつだい	カンゲツダイ	名詞サ変	
かんげんとう	かんげんとう	名詞サ変	
かしょや	カ所→	名詞	
きくちまさとも	キクチマサトモ	名詞サ変	
きくちりょうすけ	キクチリョウスケ	名詞サ変	
きくえ	キクヱ	名	
きくこ	キク子	名	
ぎじん	ｷﾞｼﾞﾝ	名詞サ変	
きせやま	キセヤマ	名詞サ変	
きたにほんでんせんかぶしきがいしゃ	キタニホンデンセンカブシキガイシャ	名詞サ変	
きたにほんでんせんさーびすかぶしきがいしゃ	キタニホンデンセンサービスカブシキガイシャ	名詞サ変	
きのした	キノシタ	名詞サ変	
きのしたまこと	キノシタマコト	名詞サ変	
きほん	キホン	名詞サ変	
きゃた	キャタ	名詞サ変	
きゃっち	ｷｬｯﾁ	名詞サ変	
きゅーぴーたまごかぶしきがいしゃ	キューピータマゴカブシキガイシャ	名詞サ変	
きゅーぴくる	キューピクル	名詞サ変	
きゅーぴくるとう	キューピクル等	名詞	
きょうえいいかずちもとかぶしきがいしゃ	キョウエイイカズチモトカブシキガイシャ	名詞サ変	
きょうとふきょうとしかみぎょうくほりかわどおりてらのうちじ	キョウトフキョウトシカミギョウクホリカワドオリテラノウチジ	名詞サ変	
きょうばしMIDびる	キョウバシＭＩＤビル	名詞サ変	
きょー	キョー	名詞サ変	
きよすみ	キヨスミ	名詞サ変	
きよまさ	キヨマサ	名詞サ変	
きりい	キリイ	名詞サ変	
きりふき	キリフキ	名詞サ変	
きりふきだい	キリフキ代	名詞	
きんじょう	ｷﾝｼﾞｮｳ	名詞サ変	
ぐうぱー	グウパー	名詞サ変	
くさかりじびか	クサカリジビカ	名詞サ変	
くっしょん	ｸｯｼｮﾝ	名詞	
くどう	クドウ	名詞サ変	
くどうさんぎょうかぶしきがいしゃ	クドウサンギョウカブシキガイシャ	名詞サ変	
くらっく	ｸﾗｯｸ	名詞サ変	
くらんぷ	ｸﾗﾝﾌﾟ	名詞サ変	
ぐり	ぐり	名詞サ変	
くりーにんぐ	ｸﾘｰﾆﾝｸﾞ	名詞サ変	
くりーん	ｸﾘｰﾝ	名詞形動	
ぐりーんねっと	ｸﾞﾘｰﾝﾈｯﾄ	名詞サ変	
くりえいてぃぶ	ｸﾘｴｲﾃｨﾌﾞ	名詞形動	
くりさき	クリサキ	名詞サ変	
くりすたるほわいと	ｸﾘｽﾀﾙﾎﾜｲﾄ	名詞サ変	
ぐるーぶかよう	グルーブ化用	接尾一般	
ぐるーぶかよう	グルーブ化用	名詞	
くるま	ｸﾙﾏ	名詞サ変	
くれあほーむこんさるてぃんぐかぶしきがいしゃ	クレアホームコンサルティングカブシキガイシャ	名詞サ変	
ぐれー	ｸﾞﾚｰ	名詞形動	
ぐれーちんぐ	ｸﾞﾚｰﾁﾝｸﾞ	名詞	
くれーん	ｸﾚｰﾝ	名詞	
くれせんと	ｸﾚｾﾝﾄ	名詞	
くろーざー	ｸﾛｰｻﾞｰ	名詞	
ぐろーぶ	ｸﾞﾛｰﾌﾞ	名詞サ変	
ぐろーぶ	グローブ	名詞サ変	
ぐろーぶしっぷかぶしきがいしゃ	グローブシップカブシキガイシャ	名詞サ変	
くろす	ｸﾛｽ	名詞サ変	
くわのはら	クワノハラ	名詞サ変	
くわのはらびる	クワノハラビル	名詞	
けい	ケイ	名詞サ変	
けいかる	ケイカル	名詞サ変	
けいでぃーでぃーあいかぶしきがいしゃ	ケイディーディーアイカブシキガイシャ	名詞サ変	
けいひんきゅうこうでんてつかぶしきがいしゃ	ケイヒンキュウコウデンテツカブシキガイシャ	名詞サ変	
けーおーいんてりあ	ｹｰｵｰｲﾝﾃﾘｱ	名詞サ変	
けきゅう6ちょうめ149ばんち1	ケキュウ６チョウメ１４９バンチ１	名詞サ変	
けらば	ケラバ	名詞サ変	
けれん	ｹﾚﾝ	名詞サ変	
けん	ｹﾝ	名詞サ変	
けん	ケン	名詞サ変	
けんきゅうかいはつほうじんにほんげんしりょくけんきゅうかい	ケンキュウカイハツホウジンニホンゲンシリョクケンキュウカイ	名詞サ変	
けんどん	ケンドン	名詞サ変	
げんばじむしょ	ゲンバジムショ	名詞サ変	
けんみん	ケンミン	名詞サ変	
けんめい	ｹﾝﾒｲ	名詞サ変	
けんめい	ケンメイ	名詞サ変	
けんりつ	ケンリツ	名詞サ変	
かげつや	ヶ月→	名詞	
かげつほど	ヶ月程	名詞	
こあざ	ｺｱｻﾞ	名詞サ変	
こう	こう	名詞サ変	
ごう	ゴウ	名詞サ変	
ごう	ごう	名詞サ変	
こうえきざいだんほうじんかなもりかずしかい	コウエキザイダンホウジンカナモリカズシカイ	名詞サ変	
こうえきざいだんほうじんやまがたけんすぽーつきょうかい	コウエキザイダンホウジンヤマガタケンスポーツキョウカイ	名詞サ変	
こうえきざいだんほうじんやまがたびじゅつかん	コウエキザイダンホウジンヤマガタビジュツカン	名詞サ変	
こうえきしゃだんほうじんやまがたけんしりつがっこうそうれ	コウエキシャダンホウジンヤマガタケンシリツガッコウソウレ	名詞サ変	
こうえきしゃだんほうじんやまがたこうきょうがくきょうかい	コウエキシャダンホウジンヤマガタコウキョウガクキョウカイ	名詞サ変	
こうざん	コウザン	名詞サ変	
こうしゅう	コウシュウ	名詞サ変	
こうしゅうじびいんこうかいいん	コウシュウジビインコウカイイン	名詞サ変	
こうじょうちょう	コウジョウチョウ	名詞サ変	
こうねつ	ｺｳﾈﾂ	名詞サ変	
こうりついわせびょういんきぎょうだん	コウリツイワセビョウインキギョウダン	名詞サ変	
こうもん	こう門	名詞	
こうもんか	こう門科	名詞	
こーと	ｺｰﾄ	名詞サ変	
こーなー	ｺｰﾅｰ	助数詞	
こーなー	ｺｰﾅｰ	名詞	
こおりやまし	コオリヤマシ	名詞サ変	
こおりやましとみたまち	コオリヤマシトミタマチ	名詞サ変	
こかわでんきこうぎょうかぶしきがいしゃ	コカワデンキコウギョウカブシキガイシャ	名詞サ変	
こくゆうりん	コクユウリン	名詞サ変	
こくりつけんきゅうかいはつほうじんしんりんけんきゅう・せ	コクリツケンキュウカイハツホウジンシンリンケンキュウ・セ	名詞サ変	
ここからした	ここから下	名詞	
ごじょうもく	ごじょうもく	名詞サ変	
こすとめりっと	コストメリット	名詞サ変	
こせき	ｺｾｷ	名詞サ変	
ごて	ｺﾞﾃ	接尾一般	
こにし	コニシ	名詞サ変	
こねくと	ｺﾈｸﾄ	名詞サ変	
こぴーか	コピー可	名詞	
こぴーさき	コピー左記	名詞	
こぶな	コブナ	名詞サ変	
こまき	ｺﾏｷ	名詞サ変	
ごむ	ｺﾞﾑ	名詞	
こむびる	コムビル	名詞	
こもて	コモテ	名詞サ変	
こやまかんこうかいはつかぶしきがいしゃ	コヤマカンコウカイハツカブシキガイシャ	名詞サ変	
ごらい	ゴライ	名詞サ変	
ごりょうしゃ	ごりょうしゃ	名詞サ変	
こわり	コワリ	名詞サ変	
こんかー	コンカー	名詞サ変	
こんがら	コンガラ	名詞サ変	
こんくりーとがら	コンクリートガラ	名詞	
こんせんと	ｺﾝｾﾝﾄ	名詞	
こんせんとばん	コンセント盤	名詞	
こんの	コンノ	名詞サ変	
こんのさとし	コンノサトシ	名詞サ変	
こんのさん	コンノさん	名詞	
こんぱくとでっき	ｺﾝﾊﾟｸﾄﾃﾞｯｷ	名詞サ変	
こんふぃんぐ	コンフィング	名詞サ変	
こんぷら	コンプラ	名詞サ変	
こんぽんせきゆかぶしきがいしゃ	コンポンセキユカブシキガイシャ	名詞サ変	
さーびす	ｻｰﾋﾞｽ	名詞サ変	
さーべめーたー	サーベメーター	名詞サ変	
さいでぃんぐ	ｻｲﾃﾞｨﾝｸﾞ	名詞	
さいとう	サイトウ	名詞サ変	
さいとうかんこうぎょう	サイトウカンコウギョウ	名詞サ変	
さいほく	サイホク	名詞サ変	
さいほく	さいほく	名詞サ変	
さいん	ｻｲﾝ	名詞サ変	
さいんや	サイン→	名詞	
ざうるす	ｻﾞｳﾙｽ	固有名詞	
さおりー	サオリー	名詞サ変	
さが	サガ	名詞サ変	
さかい	サカイ	名詞サ変	
さかえまち	サカエマチ	名詞サ変	
さかきさま	サカキ様	名詞	
さがみ	サガミ	名詞サ変	
さかもと	ｻｶﾓﾄ	名詞サ変	
さかもと	サカモト	名詞サ変	
さがわ	さがわ	名詞サ変	
さくらい	サクライ	名詞サ変	
ささもく	ササモク	名詞サ変	
さちこ	サチ子	名	
さとう	ｻﾄｳ	名詞サ変	
さとう	サトウ	名詞サ変	
さとういんてりあ	サトウインテリア	名詞サ変	
さとうけんた	サトウケンタ	名詞サ変	
さとうじゅんこ	サトウジュンコ	名詞サ変	
さとうのりこ	サトウノリコ	名詞サ変	
さとる	ｻﾄﾙ	名詞サ変	
さとる	サトル	名詞サ変	
さぷらやー	サプラヤー	名詞サ変	
さぼう	サボウ	名詞サ変	
さぼうかいかんほんかん4かい	サボウカイカンホンカン４カイ	名詞サ変	
さんじゅうにんまち49ばんちの225	サンジュウニンマチ４９バンチノ２２５	名詞サ変	
さんせい	サンセイ	名詞サ変	
さんせいいきかぶしきがいしゃ	サンセイイキカブシキガイシャ	名詞サ変	
さんせき	サンセキ	名詞サ変	
さんだー	ｻﾝﾀﾞｰ	名詞サ変	
さんだいや	ｻﾝﾀﾞｲﾔ	名詞サ変	
さんどいっちぱねる	ｻﾝﾄﾞｲｯﾁﾊﾟﾈﾙ	名詞サ変	
さんぷる	ｻﾝﾌﾟﾙ	名詞サ変	
さんたんとう	さん担当	名詞サ変	
さんぶん	さん分	接尾一般	
さんぶん	さん分	名詞	
しーすけーぶる	ｼｰｽｹｰﾌﾞﾙ	名詞サ変	
しーと	ｼｰﾄ	名詞	
しーとかん	シート間	名詞	
しーとしよう	シート使用	名詞サ変	
しいな	シイナ	名詞サ変	
しーめんすへるすけあかぶしきがいしゃ	シーメンスヘルスケアカブシキガイシャ	名詞サ変	
しーる	ｼｰﾙ	名詞サ変	
じぇっと	ｼﾞｪｯﾄ	名詞	
じおてっく	ｼﾞｵﾃｯｸ	名詞サ変	
じかわら67ばんちの13	ジカワラ６７バンチノ１３	名詞サ変	
しきがいしゃみよしどう	シキガイシャミヨシドウ	名詞サ変	
しきさい	しきさい	名詞サ変	
しくちょうそん	シクチョウソン	名詞サ変	
しくちょうそんめい	ｼｸﾁｮｳｿﾝﾒｲ	名詞サ変	
しくちょうそんめい	シクチョウソンメイ	名詞サ変	
しくちょうそんめい	シクチョウソン名	名詞	
じけいだいがわら196ばんち1	ジケイダイガワラ１９６バンチ１	名詞サ変	
しげき	シゲキ	名詞サ変	
じすろん	ジスロン	名詞サ変	
しだっくすふーどさーびすかぶしきがいしゃ	シダックスフードサービスカブシキガイシャ	名詞サ変	
したまち13ばん8ごう	シタマチ１３バン８ゴウ	名詞サ変	
しちずんましなりーかぶしきがいしゃ	シチズンマシナリーカブシキガイシャ	名詞サ変	
しちょうそん	シチョウソン	名詞サ変	
しっこうやくいんしてんちょう	ｼｯｺｳﾔｸｲﾝｼﾃﾝﾁｮｳ	名詞サ変	
してん	シテン	名詞サ変	
じない	ジナイ	名詞サ変	
じない	じない	名詞サ変	
しねは	シネハ	名詞サ変	
しはんにゅう	しはんにゅう	名詞サ変	
じび	ジビ	名詞サ変	
じふぇにる	ｼﾞﾌｪﾆﾙ	名詞	
じぶとーん	ジブトーン	名詞サ変	
じぷとーん	ジプトーン	名詞サ変	
しぶや	シブヤ	名詞サ変	
じまえばやし10ばんちの4	ジマエバヤシ１０バンチノ４	名詞サ変	
しまむら	シマムラ	名詞サ変	
しみずそうごうかいはつかぶしきがいしゃ	シミズソウゴウカイハツカブシキガイシャ	名詞サ変	
じむしょ	ｼﾞﾑｼｮ	名詞サ変	
しめい	ｼﾒｲ	名詞サ変	
しめい	シメイ	名詞サ変	
しめいふりがな	ｼﾒｲﾌﾘｶﾞﾅ	名詞サ変	
じめでぃあまにゅふぁくちゃりんぐかぶしきがいしゃ	ジメディアマニュファクチャリングカブシキガイシャ	名詞サ変	
しもかわらおき	シモカワラオキ	名詞サ変	
しもこし	シモコシ	名詞サ変	
じゃ	ジャ	名詞サ変	
しゃかい	シャカイ	名詞サ変	
しゃかいいりょうほうじん	シャカイイリョウホウジン	名詞サ変	
しゃかいいりょうほうじんめいわかい	シャカイイリョウホウジンメイワカイ	名詞サ変	
しゃかいふくしほうじんいずみかい	シャカイフクシホウジンイズミカイ	名詞サ変	
しゃかいふくしほうじんおおたふくしきねんかい	シャカイフクシホウジンオオタフクシキネンカイ	名詞サ変	
しゃかいふくしほうじんきぼうえん	シャカイフクシホウジンキボウエン	名詞サ変	
しゃかいふくしほうじんこうようかい	シャカイフクシホウジンコウヨウカイ	名詞サ変	
しゃかいふくしほうじんせんだいしみんせいじどういいんかい	シャカイフクシホウジンセンダイシミンセイジドウイインカイ	名詞サ変	
しゃかいふくしほうじんたえひかりふくしかい	シャカイフクシホウジンタエヒカリフクシカイ	名詞サ変	
しゃかいふくしほうじんちゃれんじどらいふ	シャカイフクシホウジンチャレンジドライフ	名詞サ変	
しゃかいふくしほうじんとうほくふくしかい	シャカイフクシホウジントウホクフクシカイ	名詞サ変	
しゃかいふくしほうじんみのりかい	シャカイフクシホウジンミノリカイ	名詞サ変	
しゃかいふくしほうひとゆしんえん	シャカイフクシホウヒトユシンエン	名詞サ変	
しゃったー	ｼｬｯﾀｰ	名詞サ変	
じゃぱん	ｼﾞｬﾊﾟﾝ	地名	
じゃぱん	ｼﾞｬﾊﾟﾝ	組織	
しゃりょう	ｼｬﾘｮｳ	名詞サ変	
しゃるてぃ・ぷろだくつ・じゃぱんかぶしきがいしゃ	シャルティ・プロダクツ・ジャパンカブシキガイシャ	名詞サ変	
しゃわー	ｼｬﾜｰ	名詞	
じゅうしょ	ｼﾞｭｳｼｮ	名詞サ変	
じゅうしょ	ジュウショ	名詞サ変	
しゅーとしよう	シュート使用	名詞サ変	
しゅくしゃ	ｼｭｸｼｬ	名詞サ変	
じゅらく	ジュラク	名詞サ変	
じょいんと	ｼﾞｮｲﾝﾄ	名詞サ変	
じょいんとぶ	ｼﾞｮｲﾝﾄ部	名詞	
じょうき	ジョウキ	名詞サ変	
じょうきいがい	ジョウキ以外	名詞	
しょうごう	ショウゴウ	名詞サ変	
しょうこー	ショウコー	名詞サ変	
しょうた	ｼｮｳﾀ	名詞サ変	
しょうた	ショウタ	名詞サ変	
しょうたろう	ｼｮｳﾀﾛｳ	名詞サ変	
しょうはんちない	ショウハンチナイ	名詞サ変	
しょー	ｼｮｰ	名詞	
しょっぷ	ｼｮｯﾌﾟ	名詞	
しろいしし	シロイシシ	名詞サ変	
しろいししちょう	シロイシシチョウ	名詞サ変	
じんくりっち	ジンクリッチ	名詞サ変	
しんぐるべっと	シングルベット	名詞サ変	
しんじゅく	シンジュク	名詞サ変	
しんじゅくく	シンジュクク	名詞サ変	
しんじゅくくわのはらびる6F	シンジュククワノハラビル６Ｆ	名詞サ変	
しんじゅくすみともびる42かい	シンジュクスミトモビル４２カイ	名詞サ変	
しんじょう	シンジョウ	名詞サ変	
しんせいしぱるぷしょうじかぶしきがいしゃ	シンセイシパルプショウジカブシキガイシャ	名詞サ変	
しんどう	シンドウ	名詞サ変	
しんびしれいねつこうぎょうかぶしきがいしゃ	シンビシレイネツコウギョウカブシキガイシャ	名詞サ変	
しんふさいち1ばんち	シンフサイチ１バンチ	名詞サ変	
しんぶんしゃ	シンブンシャ	名詞サ変	
しんや	ｼﾝﾔ	名詞サ変	
しんや	シンヤ	名詞サ変	
すいっち	ｽｲｯﾁ	名詞サ変	
すーぱー	ｽｰﾊﾟｰ	名詞	
すがい	ｽｶﾞｲ	名詞サ変	
すがの2ちょうめ17ばん11ごう	スガノ２チョウメ１７バン１１ゴウ	名詞サ変	
すかわ	スカワ	名詞サ変	
すきっぷよう	スキップ用	名詞	
すく	スク	名詞サ変	
すこっと	ｽｺｯﾄ	名詞サ変	
すずとよ	スズトヨ	名詞サ変	
すたいろ	スタイロ	名詞サ変	
すたいろとう	スタイロ等	名詞	
すちーる	ｽﾁｰﾙ	名詞サ変	
すちっぷる	スチップル	名詞サ変	
すてっぷる	ステップル	名詞サ変	
すぱいらる	ｽﾊﾟｲﾗﾙ	名詞	
すぱん	ｽﾊﾟﾝ	名詞	
すぱんどれる	ｽﾊﾟﾝﾄﾞﾚﾙ	名詞	
すぴーかー	ｽﾋﾟｰｶｰ	名詞	
すぺーす	ｽﾍﾟｰｽ	名詞	
すべて	ｽﾍﾞﾃ	名詞サ変	
すぽっとらいと	ｽﾎﾟｯﾄﾗｲﾄ	名詞サ変	
すみともふどうさんしながわこうなんびる	スミトモフドウサンシナガワコウナンビル	名詞サ変	
すらぶ	ｽﾗﾌﾞ	固有名詞	
すらぶごと	スラブ毎	名詞	
ずれるや	ずれる→	名詞	
すろーぷ	ｽﾛｰﾌﾟ	名詞サ変	
せい	ｾｲ	名詞サ変	
せいでん	セイデン	名詞サ変	
せいなんしょうじ	セイナンショウジ	名詞サ変	
せいぱーそー	ｾｲﾊﾟｰｿｰ	名詞サ変	
せいぱーそー	セイパーソー	名詞サ変	
せいほうにんこうれい・しょうがい・きゅうしょくしゃこよう	セイホウニンコウレイ・ショウガイ・キュウショクシャコヨウ	名詞サ変	
せいわ	セイワ	名詞サ変	
せいわがくえんたんきだいがく	セイワガクエンタンキダイガク	名詞サ変	
せーぱーそー	セーパーソー	名詞サ変	
せーぱーそーしよう	セーパーソー使用	名詞サ変	
せきすいかがくこうぎょうかぶしきがいしゃ	セキスイカガクコウギョウカブシキガイシャ	名詞サ変	
せきすいめでぃかる	ｾｷｽｲﾒﾃﾞｨｶﾙ	名詞サ変	
せきすいめでぃかる	セキスイメディカル	名詞サ変	
せきすいめでぃかるかぶしきがいしゃ	セキスイメディカルカブシキガイシャ	名詞サ変	
せきの	セキノ	名詞サ変	
せきゅりてぃ	ｾｷｭﾘﾃｨ	名詞	
せこむかぶしきがいしゃ	セコムカブシキガイシャ	名詞サ変	
ぜびおかぶしきがいしゃ	ゼビオカブシキガイシャ	名詞サ変	
ぜびおほーるでぃんぐすかぶしきがいしゃ	ゼビオホールディングスカブシキガイシャ	名詞サ変	
せぶん	ｾﾌﾞﾝ	名詞	
せら	セラ	名詞サ変	
ぜらいすかぶしきがいしゃ	ゼライスカブシキガイシャ	名詞サ変	
せらてくと	ｾﾗﾃｸﾄ	名詞サ変	
せらてくと	セラテクト	名詞サ変	
せるいち	セル位置	名詞サ変	
せれぶ	ｾﾚﾌﾞ	固有名詞	
せん	セン	名詞サ変	
せんさー	ｾﾝｻｰ	名詞	
せんたー	ｾﾝﾀｰ	名詞	
せんだいうんそうかぶしきがいしゃ	センダイウンソウカブシキガイシャ	名詞サ変	
せんだいかんこうかぶしきがいしゃ	センダイカンコウカブシキガイシャ	名詞サ変	
せんだいし	センダイシ	名詞サ変	
せんだいし	せんだいし	名詞サ変	
せんだいしあおばく	センダイシアオバク	名詞サ変	
せんだいしょうこうかいぎしょ	センダイショウコウカイギショ	名詞サ変	
せんだいにっかんいんさつかぶしきがいしゃ	センダイニッカンインサツカブシキガイシャ	名詞サ変	
そうかがっかい	ソウカガッカイ	名詞サ変	
そうきょく	ソウキョク	名詞サ変	
そうしょううんそうかぶしきがいしゃ	ソウショウウンソウカブシキガイシャ	名詞サ変	
そうちゃん	そうちゃん	名詞	
そーご	ソーゴ	名詞サ変	
そーび	ソービ	名詞サ変	
そーなど	ソー等	名詞	
そしきめい	ソシキメイ	名詞サ変	
そにーぐるーぷかぶしきがいしゃ	ソニーグループカブシキガイシャ	名詞サ変	
そにーすとれーじ	ソニーストレージ	名詞サ変	
そんがいほけんじゃぱんかぶしきがいしゃ	ソンガイホケンジャパンカブシキガイシャ	名詞サ変	
そんぽ	ソンポ	名詞サ変	
だい・やい	ダイ・ヤイ	名詞サ変	
だい1じわり11－33	ダイ１ジワリ１１－３３	名詞サ変	
だい4ちょうめ3ばん7ごう	ダイ４チョウメ３バン７ゴウ	名詞サ変	
だいあしてぃ2000もにわだんちかんりくみあい	ダイアシティ２０００モニワダンチカンリクミアイ	名詞サ変	
だいがく	ダイガク	名詞サ変	
たいきしゃ	タイキシャ	名詞サ変	
だいすけ	ダイスケ	名詞サ変	
たいせいびるかんりかぶしきがいしゃ	タイセイビルカンリカブシキガイシャ	名詞サ変	
だいとく	ダイトク	名詞サ変	
だいのっく	ﾀﾞｲﾉｯｸ	名詞サ変	
だいのっくしーと	ﾀﾞｲﾉｯｸｼｰﾄ	名詞サ変	
だいのっくしーと	ダイノックシート	名詞サ変	
だいひょうとりしまりやく	ダイヒョウトリシマリヤク	名詞サ変	
だいびる	ダイビル	名詞サ変	
だいふれっくす	ダイフレックス	名詞サ変	
だいやい	ダイヤイ	名詞サ変	
だいやぱーく	ﾀﾞｲﾔﾊﾟｰｸ	名詞サ変	
だいやぱーく	ダイヤパーク	名詞サ変	
だいやるちぇーん	ﾀﾞｲﾔﾙﾁｪｰﾝ	名詞サ変	
たいようにっさんかぶしきがいしゃ	タイヨウニッサンカブシキガイシャ	名詞サ変	
たいようにっさんひがしかんとうかぶしきがいしゃ	タイヨウニッサンヒガシカントウカブシキガイシャ	名詞サ変	
だいよんちわり	ダイヨンチワリ	名詞サ変	
たいる	ﾀｲﾙ	名詞	
だいわこうぎょうかぶしきがいしゃ	ダイワコウギョウカブシキガイシャ	名詞サ変	
だいわしょうけんかぶしきがいしゃ	ダイワショウケンカブシキガイシャ	名詞サ変	
だうんらいと	ﾀﾞｳﾝﾗｲﾄ	名詞サ変	
たかさごねつがくこうぎょうかぶしきがいしゃ	タカサゴネツガクコウギョウカブシキガイシャ	名詞サ変	
たかし	ﾀｶｼ	名詞サ変	
たかし	タカシ	名詞サ変	
たかしろ	ﾀｶｼﾛ	名詞サ変	
たかだ	タカダ	名詞サ変	
たかなしにゅうぎょうかぶしきがいしゃ	タカナシニュウギョウカブシキガイシャ	名詞サ変	
たかはし	タカハシ	名詞サ変	
たかはし	たかはし	名詞サ変	
たかはしなおと	タカハシナオト	名詞サ変	
たかやま	ﾀｶﾔﾏ	名詞サ変	
たかやま	タカヤマ	名詞サ変	
たかゆき	タカユキ	名詞サ変	
たくす	タクス	名詞サ変	
だくとかったー	ﾀﾞｸﾄｶｯﾀｰ	名詞サ変	
だくとしよう	ダクト使用	名詞サ変	
たけだ	タケダ	名詞サ変	
たけだびる	タケダビル	名詞	
たけだびる	タケダビル	名詞サ変	
たけよし	タケヨシ	名詞サ変	
たけよし	たけよし	名詞サ変	
たちかわ	タチカワ	名詞サ変	
たちやなぎ	タチヤナギ	名詞サ変	
たっぷしよう	タップ仕様	名詞	
たてものめい	タテモノメイ	名詞サ変	
たどあんじろ	タドアンジロ	名詞サ変	
たぶや	タブ→	名詞	
たぷれっと	タプレット	名詞サ変	
たむらけんせつ	タムラケンセツ	名詞サ変	
たやくひんこうぎょうかぶしきがいしゃ	タヤクヒンコウギョウカブシキガイシャ	名詞サ変	
だん	ダン	名詞サ変	
たんき	タンキ	名詞サ変	
たんくない	タンク内	名詞	
たんとうしゃ	たんとうしゃ	名詞サ変	
ちぇっく	ﾁｪｯｸ	名詞サ変	
ちぇっくや	チェック→	名詞	
ちぇっくするため	チェックする為	名詞	
ちぇっくご	チェック後	名詞	
ちぇっくず	チェック図	名詞	
ちさんとみざわひがしかんりくみあい	チサントミザワヒガシカンリクミアイ	名詞サ変	
ちさんまんしょん	チサンマンション	名詞サ変	
ちばけんいちはらし	チバケンイチハラシ	名詞サ変	
ちばすいさんかぶしきがいしゃ	チバスイサンカブシキガイシャ	名詞サ変	
ちゅうおう	チュウオウ	名詞サ変	
ちゅうおうせいきとうほくかぶしきがいしゃ	チュウオウセイキトウホクカブシキガイシャ	名詞サ変	
ちゅうおうどおり	チュウオウドオリ	名詞サ変	
ちゅうおうびとちびるまねじめんとかぶしきがいしゃ	チュウオウビトチビルマネジメントカブシキガイシャ	名詞サ変	
ちゅうおうびるめんてなんすかぶしきがいしゃ	チュウオウビルメンテナンスカブシキガイシャ	名詞サ変	
ちゅうがいしょうこう	チュウガイショウコウ	名詞サ変	
ちゅうがいせいやくかぶしきがいしゃ	チュウガイセイヤクカブシキガイシャ	名詞サ変	
ちょう	チョウ	名詞サ変	
ちょういきばんち	チョウイキバンチ	名詞サ変	
ちょういきめい	ﾁｮｳｲｷﾒｲ	名詞サ変	
ちょういきめい	チョウイキメイ	名詞サ変	
ちょうめ	チョウメ	名詞サ変	
ちよこ	チヨ子	名	
っ	ッ	名詞サ変	
ついんみなみあおやま2F	ツインミナミアオヤマ２Ｆ	名詞サ変	
つう1－6－32	ツウ１－６－３２	名詞サ変	
つう2－3－22	ツウ２－３－２２	名詞サ変	
つかみ	ツカミ	名詞サ変	
つた	ツタ	名詞サ変	
つだけ	ツダケ	名詞サ変	
っっ	ｯｯ	名詞サ変	
っっ	ッッ	名詞サ変	
つつみまち	ツツミマチ	名詞サ変	
つなぎよう	つなぎ用	名詞	
つりーさーくる	ﾂﾘｰｻｰｸﾙ	名詞サ変	
つりーず	ツリー図	名詞	
つついか	つ追加	名詞サ変	
てぃーおーしーありあけ	ティーオーシーアリアケ	名詞サ変	
でぃーぷうえる	ディープウエル	名詞サ変	
ていえむびる	テイエムビル	名詞サ変	
でぃくせ	ディクセ	名詞サ変	
でぃくせりあ	ディクセリア	名詞サ変	
でぃっぷかぶしきがいしゃ	ディップカブシキガイシャ	名詞サ変	
でーた	ﾃﾞｰﾀ	名詞	
てーぶるめい	テーブル名	名詞	
できすぱーと	デキスパート	名詞サ変	
できすぱーとや	デキスパート→	名詞	
てくすのすたー	テクスノスター	名詞サ変	
でくせりあず	デクセリアズ	名詞サ変	
でくせりあるず	ﾃﾞｸｾﾘｱﾙｽﾞ	組織	
でくせりあるずかぶしきがいしゃ	デクセリアルズカブシキガイシャ	名詞サ変	
てくにか	ﾃｸﾆｶ	組織	
てくの	テクノ	名詞サ変	
てくのこむ	テクノコム	名詞サ変	
てくのほらいぞんかぶしきがいしゃ	テクノホライゾンカブシキガイシャ	名詞サ変	
てくのる	テクノル	名詞サ変	
でっき	ﾃﾞｯｷ	名詞	
でっきすらぶ	デッキスラブ	固有名詞	
でっきなど	デッキ等	名詞	
てっこう	テッコウ	名詞サ変	
でばっか	デバッカ	名詞サ変	
でまち	デマチ	名詞サ変	
でまて	デマテ	名詞サ変	
でもか	でも可	名詞	
てらおか	テラオカ	名詞サ変	
てるうぇる	テルウェル	名詞サ変	
てるうえる	テルウエル	名詞サ変	
でれくとり	デレクトリ	名詞サ変	
でんかかぶしきがいしゃ	デンカカブシキガイシャ	名詞サ変	
てんしょん	ﾃﾝｼｮﾝ	名詞	
てんしょんかけ	テンション掛け	名詞サ変	
てんどうたーみなるびるかぶしきがいしゃ	テンドウターミナルビルカブシキガイシャ	名詞サ変	
でんろく	でん六	数	
といれ	ﾄｲﾚ	名詞	
とう	とう	名詞サ変	
とうえん	トウエン	名詞サ変	
とうかいこうねつこうぎょうかぶしきがいしゃ	トウカイコウネツコウギョウカブシキガイシャ	名詞サ変	
とうきょうしょせきかぶしきがいしゃ	トウキョウショセキカブシキガイシャ	名詞サ変	
とうきょうと	トウキョウト	名詞サ変	
とうきょうとこうとうく	トウキョウトコウトウク	名詞サ変	
とうきょうとしんじゅくく	トウキョウトシンジュクク	名詞サ変	
とうきょうとすみだく	トウキョウトスミダク	名詞サ変	
とうきょうとちよだくまるのうち	トウキョウトチヨダクマルノウチ	名詞サ変	
とうきょうとみなとく	トウキョウトミナトク	名詞サ変	
とうきょうびるでぃんぐ	トウキョウビルディング	名詞サ変	
とうけん	トウケン	名詞サ変	
とうこうでんきこうじかぶしきがいしゃ	トウコウデンキコウジカブシキガイシャ	名詞サ変	
とうほく	トウホク	名詞サ変	
とうほくけいきこうぎょうかぶしきがいしゃ	トウホクケイキコウギョウカブシキガイシャ	名詞サ変	
とうほくしてん	ﾄｳﾎｸｼﾃﾝ	名詞サ変	
とうほくしてん	トウホクシテン	名詞サ変	
とうほくでんりょくかぶしきがいしゃ	トウホクデンリョクカブシキガイシャ	名詞サ変	
とうほくもりながにゅうぎょうかぶしきがいしゃ	トウホクモリナガニュウギョウカブシキガイシャ	名詞サ変	
とうほくろうどうきんこ	トウホクロウドウキンコ	名詞サ変	
どうわ	ドウワ	名詞サ変	
どうわそんぽあおもりびる	ドウワソンポアオモリビル	名詞サ変	
とうわぷろねっつかぶしきがいしゃ	トウワプロネッツカブシキガイシャ	名詞サ変	
とーよーけむかぶしきがいしゃ	トーヨーケムカブシキガイシャ	名詞サ変	
とかちうらほろもりながにゅうぎょうかぶしきがいしゃ	トカチウラホロモリナガニュウギョウカブシキガイシャ	名詞サ変	
どきゅわーくす	ドキュワークス	名詞サ変	
とく	トク	名詞サ変	
とくひさ	ﾄｸﾋｻ	名詞サ変	
とし	トシ	名詞サ変	
としひろ	ﾄｼﾋﾛ	名詞サ変	
とっぱん	トッパン	名詞サ変	
とっぷこーと	ﾄｯﾌﾟｺｰﾄ	名詞サ変	
とっぷとそう	トップ塗装	名詞サ変	
とどうふけん	トドウフケン	名詞サ変	
とどうふけんめい	ﾄﾄﾞｳﾌｹﾝﾒｲ	名詞サ変	
どみーる	ドミール	名詞サ変	
とみた	トミタ	名詞サ変	
とめし	トメシ	名詞サ変	
ともえらいじんぐ	トモエライジング	名詞サ変	
とよしまく	ﾄﾖｼﾏｸ	名詞サ変	
とよた	トヨタ	名詞サ変	
とよだ	トヨダ	名詞サ変	
とよてつとうほくかぶしきがいしゃ	トヨテツトウホクカブシキガイシャ	名詞サ変	
とらっく	ﾄﾗｯｸ	名詞サ変	
とらまるまち	トラマルマチ	名詞サ変	
とるかなど	とるか等	名詞	
どれっぷかーてん	ドレップカーテン	名詞サ変	
とれんちない	トレンチ内	名詞	
とわだし	トワダシ	名詞サ変	
ない	ナイ	名詞サ変	
なおき	ﾅｵｷ	名詞サ変	
なおふみしゅっぱんかぶしきがいしゃ	ナオフミシュッパンカブシキガイシャ	名詞サ変	
なか	ナカ	名詞サ変	
なかざわ	なかざわ	名詞サ変	
なかたちょう	ナカタチョウ	名詞サ変	
なかだちょうたからえあらいだ	ナカダチョウタカラエアライダ	名詞サ変	
なかだちょうたからえにいだかがのさかい	ナカダチョウタカラエニイダカガノサカイ	名詞サ変	
なかどおり	ナカドオリ	名詞サ変	
なすきー	ナスキー	名詞サ変	
なたがちょう	ﾅﾀｶﾞﾁｮｳ	名詞サ変	
なつこ	ナツコ	名詞サ変	
なとりし	ナトリシ	名詞サ変	
ななじゅうななしょうけんかぶしきがいしゃ	ナナジュウナナショウケンカブシキガイシャ	名詞サ変	
なにがし	ﾅﾆｶﾞｼ	名詞サ変	
なのとっぷ	ﾅﾉﾄｯﾌﾟ	名詞サ変	
なふりがな	ﾅﾌﾘｶﾞﾅ	名詞サ変	
なみえかいたいさぎょうしょ	ﾅﾐｴｶｲﾀｲｻｷﾞｮｳｼｮ	名詞サ変	
なみえかいたいさぎょうしょ	ナミエカイタイサギョウショ	名詞サ変	
なめず	ナメズ	名詞サ変	
ならはうんゆゆうげんがいしゃ	ナラハウンユユウゲンガイシャ	名詞サ変	
なりた	ナリタ	名詞サ変	
なりたびる1F	ナリタビル１Ｆ	名詞サ変	
なんばりんぐ	ﾅﾝﾊﾞﾘﾝｸﾞ	名詞サ変	
にーず	ﾆｰｽﾞ	名詞	
にたしょりで	にたしょりで	名詞サ変	
にちべい	ニチベイ	名詞サ変	
にちほ	ニチホ	名詞サ変	
にちょう4ばんちの2	ニチョウ４バンチノ２	名詞サ変	
にちょうめ	ニチョウメ	名詞サ変	
にちょうめ	にちょうめ	名詞サ変	
にっかういすきーかぶしきがいしゃ	ニッカウイスキーカブシキガイシャ	名詞サ変	
にっかでぃすてぃらりーさーびすかぶしきがいしゃ	ニッカディスティラリーサービスカブシキガイシャ	名詞サ変	
にっかん	ニッカン	名詞サ変	
にっかんすぽーつしんぶんしゃとうほくそうきょくない	ニッカンスポーツシンブンシャトウホクソウキョクナイ	名詞サ変	
にっきそうかぶしきがいしゃ	ニッキソウカブシキガイシャ	名詞サ変	
にっさん	ニッサン	名詞サ変	
にっしんかさいかいじょうほけんかぶしきがいしゃ	ニッシンカサイカイジョウホケンカブシキガイシャ	名詞サ変	
にっしんせつびかぶしきがいしゃ	ニッシンセツビカブシキガイシャ	名詞サ変	
にっすい・えんじにありんぐかぶしきがいしゃ	ニッスイ・エンジニアリングカブシキガイシャ	名詞サ変	
にっとうこうきかぶしきがいしゃ	ニットウコウキカブシキガイシャ	名詞サ変	
にほんげんねん	ニホンゲンネン	名詞サ変	
にほんげんねんかぶしきがいしゃ	ニホンゲンネンカブシキガイシャ	名詞サ変	
にほんちゅうおうけいばかい	ニホンチュウオウケイバカイ	名詞サ変	
にほんつううんかぶしきがいしゃ	ニホンツウウンカブシキガイシャ	名詞サ変	
にほんとしふぁんどとうしほうじん	ニホントシファンドトウシホウジン	名詞サ変	
にほんほうそうきょうかい	ニホンホウソウキョウカイ	名詞サ変	
にゅーこてえーす	ニューコテエース	名詞サ変	
にゅーじぇっく	ニュージェック	名詞サ変	
にもり	に盛り	名詞サ変	
ねおはいつ・う゛ぇ	ネオハイツ・ヴェ	名詞サ変	
ねっと	ﾈｯﾄ	名詞	
ねもと	ネモト	名詞サ変	
のうち	のうち	名詞サ変	
のしろし	ノシロシ	名詞サ変	
のとおり	のとおり	名詞	
のむらぷろぱてぃーずかぶしきがいしゃ	ノムラプロパティーズカブシキガイシャ	名詞サ変	
のりぱーく	のﾘﾊﾟｰｸ	名詞	
のりぱーく	のリパーク	名詞	
のりとう	のり等	名詞	
のんあすえーす	ノンアスエース	名詞サ変	
のんあすべっとたいる	ノンアスベットタイル	名詞サ変	
ぱーくがーでん	ﾊﾟｰｸｶﾞｰﾃﾞﾝ	名詞サ変	
ぱーくがーでん	パークガーデン	名詞サ変	
ばーちかる	ﾊﾞｰﾁｶﾙ	名詞形動	
ぱーていしょん	パーテイション	名詞サ変	
ばーなー	ﾊﾞｰﾅｰ	名詞	
ばい	バイ	名詞サ変	
はいうおっしゃー	ハイウオッシャー	名詞サ変	
はいけだけど	はいけだけど	名詞サ変	
ばいせっぷす	バイセップス	名詞サ変	
はいどばん	ハイドバン	名詞サ変	
はいぱうだー	ハイパウダー	名詞サ変	
はいふんあり	ハイフン有り	名詞	
ぴぉt	パイロット	名詞形動	
はうす	ﾊｳｽ	名詞	
はうすめいと	ﾊｳｽﾒｲﾄ	名詞サ変	
ばくろ	ばく露	名詞	
はざま	ハザマ	名詞サ変	
はしもとじしょ	ハシモトジショ	名詞サ変	
はせがわ	ﾊｾｶﾞﾜ	名詞サ変	
ぱたーん	ﾊﾟﾀｰﾝ	名詞	
はちまんたいらし	ハチマンタイラシ	名詞サ変	
はっちゅうしゃめい	ハッチュウシャメイ	名詞サ変	
はっとり	ハットリ	名詞サ変	
はつり	ハツリ	名詞サ変	
ぱと	パト	名詞サ変	
はにゅう	ハニュウ	名詞サ変	
ぱねこーと	パネコート	名詞サ変	
はねだ	ﾊﾈﾀﾞ	名詞サ変	
ぱねる	ﾊﾟﾈﾙ	名詞	
はまつ	ハマツ	名詞サ変	
はまつかんこうかぶしきがいしゃ	ハマツカンコウカブシキガイシャ	名詞サ変	
はみでてい	はみ出て要	動詞ラ行五段	
はやし	ハヤシ	名詞サ変	
はら	ハラ	名詞サ変	
はらことば	ハラコトバ	名詞サ変	
ぱらぼな	パラボナ	名詞サ変	
ばらんす	ﾊﾞﾗﾝｽ	名詞	
ばりかー	バリカー	名詞サ変	
ぱれあなびる8かい	パレアナビル８カイ	名詞サ変	
ぱわーほるす	ﾊﾟﾜｰﾎﾙｽ	名詞サ変	
ぱわーほるす	パワーホルス	名詞サ変	
ばん	バン	名詞サ変	
ばん	ばん	名詞サ変	
はんが	ﾊﾝｶﾞ	名詞サ変	
ばんけんふぇいす	バンケンフェイス	名詞サ変	
ばんざいびる	バンザイビル	名詞	
ばんち	バンチ	名詞サ変	
ぱんちんぐ	ﾊﾟﾝﾁﾝｸﾞ	名詞サ変	
はんどる	ﾊﾝﾄﾞﾙ	名詞サ変	
ひーたー	ﾋｰﾀｰ	名詞サ変	
ひーたー	ひーたー	名詞サ変	
びーと	ﾋﾞｰﾄ	名詞	
ひがし2ちょうめ5ばんちの5	ヒガシ２チョウメ５バンチノ５	名詞サ変	
ひがしいけぶくろ	ヒガシイケブクロ	名詞サ変	
ひがしにほんこうぎょうかぶしきがいしゃ	ヒガシニホンコウギョウカブシキガイシャ	名詞サ変	
ひがしにほんこうそくどうろかぶしきがいしゃ	ヒガシニホンコウソクドウロカブシキガイシャ	名詞サ変	
ひがしにほんでんしんでんわかぶしきがいしゃ	ヒガシニホンデンシンデンワカブシキガイシャ	名詞サ変	
ひがしねし	ヒガシネシ	名詞サ変	
ひかり	ヒカリ	名詞サ変	
ひかりびる	ヒカリビル	名詞	
ひかりびる102ごう	ヒカリビル１０２ゴウ	名詞サ変	
ひかる	ヒカル	名詞サ変	
ぴくと	ピクト	名詞サ変	
びけ	ビケ	名詞サ変	
びけん	ビケン	名詞サ変	
びけん	びけん	名詞サ変	
びすどめ	ビス止め	名詞サ変	
びそー	ビソー	名詞サ変	
ひたちAstemoかぶしきがいしゃ	ヒタチＡｓｔｅｍｏカブシキガイシャ	名詞サ変	
びにーる	ﾋﾞﾆｰﾙ	名詞	
びにしーと	ビニシート	名詞サ変	
びにる	ﾋﾞﾆﾙ	名詞	
ひねったとき	ひねった時	名詞	
ひびき	ヒビキ	名詞サ変	
ひびやそうごうせつびかぶしきがいしゃ	ヒビヤソウゴウセツビカブシキガイシャ	名詞サ変	
ひふく	ヒフク	名詞サ変	
ひもや	ひも→	名詞	
びょう	ビョウ	名詞サ変	
びょういん	ビョウイン	名詞サ変	
びょうとか	ビョウとか	名詞サ変	
びる	ﾋﾞﾙ	接尾一般	
びる	ﾋﾞﾙ	名詞	
ひるかわ	ヒルカワ	名詞サ変	
ひろしましにしくよこがわちょう3ちょうめ7－22	ヒロシマシニシクヨコガワチョウ３チョウメ７－２２	名詞サ変	
ひろふみ	ﾋﾛﾌﾐ	名詞サ変	
ひろふみ	ヒロフミ	名詞サ変	
ふぁいるや	ファイル→	名詞	
ふぁいるを	ファイルヲ	名詞サ変	
ふぁいるを	ファイルを	感動詞	
ふぁいるぐん	ファイル群	名詞	
ふぁいるない	ファイル内	名詞	
ふぁしり	ファシリ	名詞サ変	
ふいとる	フイトル	名詞サ変	
ふいとるすぷれー	フイトルスプレー	名詞サ変	
ふぃりなが	フィリナガ	名詞サ変	
ぶいるっく	ブイルック	名詞サ変	
ぶーす	ﾌﾞｰｽ	名詞	
ふぇんす	ﾌｪﾝｽ	名詞	
ふぉーむず・せんとらるぷろだくつかぶしきがいしゃ	フォームズ・セントラルプロダクツカブシキガイシャ	名詞サ変	
ふぉんt	フォント	名詞形動	
ふかせきよみ	フカセキヨミ	名詞サ変	
ふくおかくらもと	フクオカクラモト	名詞サ変	
ふくしまけん	フクシマケン	名詞サ変	
ふくしまけんくにみちょう	フクシマケンクニミチョウ	名詞サ変	
ふくしまけんたむらし	フクシマケンタムラシ	名詞サ変	
ふくしまけんふくしじぎょうきょう	フクシマケンフクシジギョウキョウ	名詞サ変	
ふくしまけんふくしまし	フクシマケンフクシマシ	名詞サ変	
ふくしまけんみなみそうましあおばちょう3－92	フクシマケンミナミソウマシアオバチョウ３－９２	名詞サ変	
ふくだ	ﾌｸﾀﾞ	名詞サ変	
ふくだ	フクダ	名詞サ変	
ふじくら	フジクラ	名詞サ変	
ふじくらこうそうかぶしきがいしゃ	フジクラコウソウカブシキガイシャ	名詞サ変	
ふじくらこんぽじっとおだかこうじょうない	フジクラコンポジットオダカコウジョウナイ	名詞サ変	
ふじくらこんぽじっとかぶしきがいしゃ	フジクラコンポジットカブシキガイシャ	名詞サ変	
ふじこう	フジコウ	名詞サ変	
ふじつうけんこうほけんくみあい	フジツウケンコウホケンクミアイ	名詞サ変	
ふじとらんすぽーとかぶしきがいしゃ	フジトランスポートカブシキガイシャ	名詞サ変	
ふじふぁしりてぃさーびすかぶしきがいしゃ	フジファシリティサービスカブシキガイシャ	名詞サ変	
ふじふいるむめでぃかるかぶしきがいしゃ	フジフイルムメディカルカブシキガイシャ	名詞サ変	
ふじふーずかぶしきがいしゃ	フジフーズカブシキガイシャ	名詞サ変	
ふじわら	フジワラ	名詞サ変	
ふじわら229ばんちの7	フジワラ２２９バンチノ７	名詞サ変	
ふじわらしゅん	フジワラシュン	名詞サ変	
ふじわらちわ	フジワラチワ	名詞サ変	
ふっく	ﾌｯｸ	名詞サ変	
ぶっくない	ブック内	名詞	
ふっだー	フッダー	名詞サ変	
ふながさき	フナガサキ	名詞サ変	
ふねこさわ6－1	フネコサワ６－１	名詞サ変	
ぶらいんど	ﾌﾞﾗｲﾝﾄﾞ	名詞	
ぶらいんど	ﾌﾞﾗｲﾝﾄﾞ	名詞サ変	
ぶらけっと	ﾌﾞﾗｹｯﾄ	名詞	
ぷらしき	プラシキ	名詞サ変	
ふらすたー	フラスター	名詞サ変	
ぶらだん	ブラダン	名詞サ変	
ぷらだん	プラダン	名詞サ変	
ふらっとぱねる	ﾌﾗｯﾄﾊﾟﾈﾙ	名詞サ変	
ふらっとぱねる	フラットパネル	名詞サ変	
ふらっとぱねるが	フラットパネルが	接続詞	
ふらっぷ	ﾌﾗｯﾌﾟ	名詞	
ふらっぷばん	ﾌﾗｯﾌﾟ板	名詞	
ぷらまーとふ	プラマー塗布	名詞サ変	
ぷらまーとふじ	プラマー塗布時	名詞	
ふらんす	ﾌﾗﾝｽ	地名	
ふりーずすること	フリーズする事	名詞	
ふりがな	ﾌﾘｶﾞﾅ	名詞サ変	
ぶりっくせん	ブリック船	名詞	
ふれき	フレキ	名詞サ変	
ふれきしぶる	ﾌﾚｷｼﾌﾞﾙ	名詞形動	
ふれこん	フレコン	名詞サ変	
ふれっしゅこんくりーと	ﾌﾚｯｼｭｺﾝｸﾘｰﾄ	名詞サ変	
ぷれみすと	プレミスト	名詞サ変	
ぷれみすとなとりえきまえ	プレミストナトリエキマエ	名詞サ変	
ぷろーじゃ	プロージャ	名詞サ変	
ふろーちゃーと	ﾌﾛｰﾁｬｰﾄ	名詞サ変	
ふろーちゃーと	フローチャート	名詞サ変	
ぶろっく	ﾌﾞﾛｯｸ	名詞サ変	
ぶろっくしよう	ブロック使用	名詞サ変	
ふんしつしないよう	ふんしつしないよう	名詞サ変	
ぺいんと	ﾍﾟｲﾝﾄ	名詞サ変	
ぺが	ペガ	名詞サ変	
へったー	ヘッター	名詞サ変	
ぺっだー	ペッダー	名詞サ変	
べにや	ﾍﾞﾆﾔ	名詞	
べにりあるえすてーとまねじめんとかぶしきがいしゃ	ベニリアルエステートマネジメントカブシキガイシャ	名詞サ変	
ぺふ	ペフ	名詞サ変	
べりーふ22	ベリーフ２２	名詞サ変	
べると	ﾍﾞﾙﾄ	名詞	
へるばんど	ヘルバンド	名詞サ変	
べんち	ﾍﾞﾝﾁ	名詞	
ほうちき	ホウチキ	名詞サ変	
ほーすだい	ホース代	名詞	
ぽーち	ﾎﾟｰﾁ	名詞サ変	
ぼーど	ﾎﾞｰﾄﾞ	名詞	
ほーむ	ﾎｰﾑ	名詞	
ほーゆーかぶしきがいしゃ	ホーユーカブシキガイシャ	名詞サ変	
ほくこうかがくこうぎょうかぶしきがいしゃ	ホクコウカガクコウギョウカブシキガイシャ	名詞サ変	
ほくようえんぎょうかぶしきがいしゃ	ホクヨウエンギョウカブシキガイシャ	名詞サ変	
ぽすたー	ﾎﾟｽﾀｰ	名詞	
ほそかわふぁみりーしかくりにっく	ホソカワファミリーシカクリニック	名詞サ変	
ほっかいどう	ホッカイドウ	名詞サ変	
ほっかいどうとっぱん・ふぉーむずかぶしきがいしゃ	ホッカイドウトッパン・フォームズカブシキガイシャ	名詞サ変	
ほっかいどうとらっくこうつうきょうさいきょうどうくみあい	ホッカイドウトラックコウツウキョウサイキョウドウクミアイ	名詞サ変	
ぼっきんぶれー	ボッキンブレー	名詞サ変	
ぼっくす	ﾎﾞｯｸｽ	名詞	
ほとろんぐるーぷ	ホトロングループ	名詞サ変	
ほまれ	ホマレ	名詞サ変	
ぽりうれたん	ﾎﾟﾘｳﾚﾀﾝ	名詞	
ほりかわどおりてらのうちじょうるてらのうちたてちょう682	ホリカワドオリテラノウチジョウルテラノウチタテチョウ６８２	名詞サ変	
ほりきりうしろしも5	ホリキリウシロシモ５	名詞サ変	
ぼりふぃるむ	ﾎﾞﾘﾌｨﾙﾑ	名詞サ変	
ぼりふぃるむ	ボリフィルム	名詞サ変	
ぽりふぃるむ	ﾎﾟﾘﾌｨﾙﾑ	名詞サ変	
ぽりふぃるむ	ポリフィルム	名詞サ変	
ぽりふぃるむで	ポリフィルムデ	名詞サ変	
ぽりぶたい	ポリブタイ	名詞サ変	
ほんかん	ホンカン	名詞サ変	
ぼんじんく	ボンジンク	名詞サ変	
ほんちょう	ホンチョウ	名詞サ変	
ぽんぷ	ﾎﾟﾝﾌﾟ	名詞サ変	
ぼんふろんらいと	ﾎﾞﾝﾌﾛﾝﾗｲﾄ	名詞サ変	
ぽんぷとう	ポンプ棟	名詞	
ほんま	ﾎﾝﾏ	名詞サ変	
ほんま	ホンマ	名詞サ変	
ほんまち	ホンマチ	名詞サ変	
ほんまち	ほんまち	名詞サ変	
まいまっぷ	マイマップ	名詞サ変	
まいるど	ﾏｲﾙﾄﾞ	名詞形動	
まうんたー	マウンター	名詞サ変	
まこと	マコト	名詞サ変	
まさあき	まさあき	名詞サ変	
まさえる	マサエル	名詞サ変	
まさし	ﾏｻｼ	名詞サ変	
まさし	マサシ	名詞サ変	
まさとし	マサトシ	名詞サ変	
まさゆき	マサユキ	名詞サ変	
まじっくだい	マジック代	名詞	
ますかー	マスカー	名詞サ変	
ますくら	マスクラ	名詞サ変	
ますくしよう	マスク使用	名詞サ変	
ますさき	マスサキ	名詞サ変	
ますだ	マスダ	名詞サ変	
ますだなおひろ	マスダナオヒロ	名詞サ変	
ますちょう	ます調	助数詞	
または	マタハ	名詞サ変	
まち23ばん7ごう	マチ２３バン７ゴウ	名詞サ変	
まち3ちょうめ264	マチ３チョウメ２６４	名詞サ変	
まち9ばん10ごう	マチ９バン１０ゴウ	名詞サ変	
まちこ	マチコ	名詞サ変	
まちながくぼ1ちょうめ10ばんち13	マチナガクボ１チョウメ１０バンチ１３	名詞サ変	
まちめい	ﾏﾁﾒｲ	名詞サ変	
まちや	ﾏﾁﾔ	名詞サ変	
まちや	マチヤ	名詞サ変	
まついこーぽれーしょん	マツイコーポレーション	名詞サ変	
まつお	マツオ	名詞サ変	
まっくす	ﾏｯｸｽ	人名	
まっくす	ﾏｯｸｽ	組織	
まっくす	ﾏｯｸｽ	固有名詞	
まっと	ﾏｯﾄ	名詞サ変	
まつばや	マツバヤ	名詞サ変	
まるいし	マルイシ	名詞サ変	
まるいちしょうじかぶしきがいしゃ	マルイチショウジカブシキガイシャ	名詞サ変	
まるきいかきかいかぶしきがいしゃ	マルキイカキカイカブシキガイシャ	名詞サ変	
まるきん	マルキン	名詞サ変	
まんじゅう	マンジュウ	名詞サ変	
みあyぎけんせんだいし	ミアｙギケンセンダイシ	名詞サ変	
みうら	ミウラ	名詞サ変	
みうらるーふさーび	ミウラルーフサービ	名詞サ変	
みくらいと	ミクライト	名詞サ変	
みずかわめ596ばんち1	ミズカワメ５９６バンチ１	名詞サ変	
みずの	ミズノ	名詞サ変	
みずほしんたくぎんこうかぶしきがいしゃ	ミズホシンタクギンコウカブシキガイシャ	名詞サ変	
みちのくこか・こーらぼとりんぐかぶしきがいしゃ	ミチノクコカ・コーラボトリングカブシキガイシャ	名詞サ変	
みちのくしりょうかぶしきがいしゃ	ミチノクシリョウカブシキガイシャ	名詞サ変	
みついすみともかいじょうあいおいせいめいほけんかぶしき	ミツイスミトモカイジョウアイオイセイメイホケンカブシキ	名詞サ変	
みついすみともしんたくぎんこうかぶしきがいしゃ	ミツイスミトモシンタクギンコウカブシキガイシャ	名詞サ変	
みつけ	ミツケ	名詞サ変	
みつびしがすかがく	ミツビシガスカガク	名詞サ変	
みつびしじしょかぶしきがいしゃ	ミツビシジショカブシキガイシャ	名詞サ変	
みつびしじしょぷろぱてぃまねじめんとかぶしきがいし	ミツビシジショプロパティマネジメントカブシキガイシ	名詞サ変	
みつびしゆーえふじぇいにこすかぶしきがいしゃ	ミツビシユーエフジェイニコスカブシキガイシャ	名詞サ変	
みつみ	ﾐﾂﾐ	組織	
みつみでんきかぶしきがいしゃ	ミツミデンキカブシキガイシャ	名詞サ変	
みなと	ミナト	名詞サ変	
みなみ3ちょうめ15ばん40ごう	ミナミ３チョウメ１５バン４０ゴウ	名詞サ変	
みなみおおどおり	ミナミオオドオリ	名詞サ変	
みなみそうまし	ミナミソウマシ	名詞サ変	
みなみどおりみそのまち	ミナミドオリミソノマチ	名詞サ変	
みやがわ	ミヤガワ	名詞サ変	
みやがわりゅうたろう	ミヤガワリュウタロウ	名詞サ変	
みやぎけん	ミヤギケン	名詞サ変	
みやぎけん	みやぎけん	名詞サ変	
みやぎけんしばたぐんおおがわらまちおおやまちむかい	ミヤギケンシバタグンオオガワラマチオオヤマチムカイ	名詞サ変	
みやぎけんしろいしし	ミヤギケンシロイシシ	名詞サ変	
みやぎけんしんようほしょうきょうかい	ミヤギケンシンヨウホショウキョウカイ	名詞サ変	
みやぎけんせんだいし	ミヤギケンセンダイシ	名詞サ変	
みやぎけんせんだいしたいはくく	ミヤギケンセンダイシタイハクク	名詞サ変	
みやぎけんせんだいしみやぎのく	ミヤギケンセンダイシミヤギノク	名詞サ変	
みやぎけんびじゅつかん	ミヤギケンビジュツカン	名詞サ変	
みやぎしょうじかぶしきがいしゃ	ミヤギショウジカブシキガイシャ	名詞サ変	
みやぎだいはつはんばいかぶしきがいしゃ	ミヤギダイハツハンバイカブシキガイシャ	名詞サ変	
みやぎとよたぐるーぷかぶしきがいしゃ	ミヤギトヨタグループカブシキガイシャ	名詞サ変	
みやぎとよたじどうしゃかぶしきがいしゃ	ミヤギトヨタジドウシャカブシキガイシャ	名詞サ変	
みやぎのく	ミヤギノク	名詞サ変	
みやぎのくみなと	ミヤギノクミナト	名詞サ変	
みやざわじ	ミヤザワジ	名詞サ変	
みらー	ﾐﾗｰ	名詞	
みるっくす	ミルックス	名詞サ変	
みんぐるやまがた	ミングルヤマガタ	名詞サ変	
むばんち	ムバンチ	名詞サ変	
めい	ﾒｲ	名詞サ変	
めい	メイ	名詞サ変	
めいくび	メイク美	名詞	
めいくびそう	メイク美創	名詞	
めいじやすだせいめいほけんそうごがいしゃ	メイジヤスダセイメイホケンソウゴガイシャ	名詞サ変	
めいしょう	メイショウ	名詞サ変	
めいぷるちゅうおうびる	メイプルチュウオウビル	名詞サ変	
めいわかい	メイワカイ	名詞サ変	
めしあわせ	めしあわせ	名詞サ変	
めっきしよう	めっき仕様	名詞	
めっしゅ	ﾒｯｼｭ	名詞	
めん	メン	名詞サ変	
もーがるそけっと	モーガルソケット	名詞サ変	
もーめんと	ﾓｰﾒﾝﾄ	名詞	
もしくは	もしくは	名詞サ変	
もっこ	モッコ	名詞サ変	
もとはせくら34－1	モトハセクラ３４－１	名詞サ変	
もにたー	ﾓﾆﾀｰ	名詞サ変	
ものする	ものする	名詞サ変	
もめんてぃぶ	モメンティブ	名詞サ変	
もらすじん	モラスジン	名詞サ変	
もりおかこうじょう	モリオカコウジョウ	名詞サ変	
もりおかし	モリオカシ	名詞サ変	
もりおかしみなみおおどおり	モリオカシミナミオオドオリ	名詞サ変	
もりながえんじにありんぐかぶしきがいしゃ	モリナガエンジニアリングカブシキガイシャ	名詞サ変	
もりのつごうどうがいしゃ	モリノツゴウドウガイシャ	名詞サ変	
もるすたー	モルスター	名詞サ変	
もるたる	ﾓﾙﾀﾙ	名詞	
もれ	モレ	名詞サ変	
やー	ヤー	名詞サ変	
やす	ヤス	名詞サ変	
やすた	ヤスタ	名詞サ変	
やの	ﾔﾉ	名詞サ変	
やの	ヤノ	名詞サ変	
やはたかいがん	ヤハタカイガン	名詞サ変	
やまがたくうこうびるかぶしきがいしゃ	ヤマガタクウコウビルカブシキガイシャ	名詞サ変	
やまがたけん	ヤマガタケン	名詞サ変	
やまがたけんりつしんじょうびょういん	ヤマガタケンリツシンジョウビョウイン	名詞サ変	
やまがたし	ヤマガタシ	名詞サ変	
やまがたしほんちょう	ヤマガタシホンチョウ	名詞サ変	
やまがたほうそうかぶしきがいしゃ	ヤマガタホウソウカブシキガイシャ	名詞サ変	
やまぎんけんみんほーる	ヤマギンケンミンホール	名詞サ変	
やましたしょういち・やましたみち	ヤマシタショウイチ・ヤマシタミチ	名詞サ変	
やまだ	ヤマダ	名詞サ変	
やまたがしほんちょう	ヤマタガシホンチョウ	名詞サ変	
やまとらいふねくすとかぶしきがいしゃ	ヤマトライフネクストカブシキガイシャ	名詞サ変	
やまみまち	ヤマミマチ	名詞サ変	
やまもとしかいいん	ヤマモトシカイイン	名詞サ変	
やらず	ヤラズ	名詞サ変	
ゆういち	ユウイチ	名詞サ変	
ゆうげんがいしゃあさの	ユウゲンガイシャアサノ	名詞サ変	
ゆうげんがいしゃあさひばす	ユウゲンガイシャアサヒバス	名詞サ変	
ゆうげんがいしゃいわまつ	ユウゲンガイシャイワマツ	名詞サ変	
ゆうげんがいしゃえんどうたばこしょうてん	ユウゲンガイシャエンドウタバコショウテン	名詞サ変	
ゆうげんがいしゃさんもじや	ユウゲンガイシャサンモジヤ	名詞サ変	
ゆうげんがいしゃじろー	ユウゲンガイシャジロー	名詞サ変	
ゆうげんがいしゃすえながほうせい	ユウゲンガイシャスエナガホウセイ	名詞サ変	
ゆうげんがいしゃひがしもりしょうじ	ユウゲンガイシャヒガシモリショウジ	名詞サ変	
ゆうげんがいしゃびしんどうほんてん	ユウゲンガイシャビシンドウホンテン	名詞サ変	
ゆうげんがいしゃむつぱーくほてる	ユウゲンガイシャムツパークホテル	名詞サ変	
ゆうげんがいしゃやましたじむしょ	ユウゲンガイシャヤマシタジムショ	名詞サ変	
ゆうげんがいしゃよしみずしょうてん	ユウゲンガイシャヨシミズショウテン	名詞サ変	
ゆうや	ユウヤ	名詞サ変	
ゆうゆう	ゆうゆう	名詞サ変	
ゆたかめいく	ﾕﾀｶﾒｲｸ	名詞サ変	
ゆにっくしゃ	ユニック車	名詞	
ゆにとん	ユニトン	名詞サ変	
ゆめこーぽれーしょんかぶしきがいしゃ	ユメコーポレーションカブシキガイシャ	名詞サ変	
よしだ	ﾖｼﾀﾞ	名詞サ変	
よしだ	ヨシダ	名詞サ変	
よしだしかいいん	ヨシダシカイイン	名詞サ変	
よつや	ヨツヤ	名詞サ変	
よねざわ	ヨネザワ	名詞サ変	
らいと	ﾗｲﾄ	名詞形動	
らいにんぐ	ﾗｲﾆﾝｸﾞ	名詞サ変	
らいん	ﾗｲﾝ	名詞サ変	
らじぇっと	ラジェット	名詞サ変	
らっち	ﾗｯﾁ	名詞サ変	
らどもる	ラドモル	名詞サ変	
らふたー	ﾗﾌﾀｰ	名詞サ変	
らふたーしよう	ラフター使用	名詞サ変	
りけんしょくひんかぶしきがいしゃ	リケンショクヒンカブシキガイシャ	名詞サ変	
りこーくりえいてぃぶさーびす	ﾘｺｰｸﾘｴｲﾃｨﾌﾞｻｰﾋﾞｽ	名詞サ変	
りこーくりえいてぃぶさーびすかぶしきがいしゃ	リコークリエイティブサービスカブシキガイシャ	名詞サ変	
りさいくる	ﾘｻｲｸﾙ	名詞サ変	
りさいくるねんりょうちょぞうかぶしきがいしゃ	リサイクルネンリョウチョゾウカブシキガイシャ	名詞サ変	
りしん	ﾘｼﾝ	名詞	
りすくあすめんと	リスクアスメント	名詞サ変	
りっちあるみにゅうむ	リッチアルミニュウム	名詞サ変	
りてぃ	リティ	名詞サ変	
りにゅーある	ﾘﾆｭｰｱﾙ	名詞サ変	
りぱーく	ﾘﾊﾟｰｸ	名詞サ変	
りぱーく	リパーク	名詞サ変	
りふぃーる	リフィール	名詞サ変	
りみったー	ﾘﾐｯﾀｰ	名詞	
りみてっど	ﾘﾐﾃｯﾄﾞ	名詞形動	
りもこん	ﾘﾓｺﾝ	名詞	
りゅうご	ﾘｭｳｺﾞ	名詞サ変	
りゅうごう	ﾘｭｳｺﾞｳ	名詞サ変	
りょうすけ	ﾘｮｳｽｹ	名詞サ変	
りょうすけ	リョウスケ	名詞サ変	
りょー	リョー	名詞サ変	
りらこべる	リラコベル	名詞サ変	
るーとず	ルート図	名詞	
るーばー	ﾙｰﾊﾞｰ	名詞サ変	
るーむ	ﾙｰﾑ	名詞	
れいや	レイヤ	名詞サ変	
れーざーとりまー	ﾚｰｻﾞｰﾄﾘﾏｰ	名詞サ変	
れーだー	ﾚｰﾀﾞｰ	名詞	
れーる	ﾚｰﾙ	名詞	
れぎおん	レギオン	名詞サ変	
れぞなっく	レゾナック	名詞サ変	
ればーはんどる	ﾚﾊﾞｰﾊﾝﾄﾞﾙ	名詞サ変	
れんたっく	レンタック	名詞サ変	
れんてっく	レンテック	名詞サ変	
れんてっくす	レンテックス	名詞サ変	
れんとーる	レントール	名詞サ変	
れんとげん	ﾚﾝﾄｹﾞﾝ	名詞	
ろーるすくりーん	ﾛｰﾙｽｸﾘｰﾝ	名詞サ変	
ろーるすくりーん	ロールスクリーン	名詞サ変	
ろじすてぃーどきたにほんかぶしきがいしゃ	ロジスティードキタニホンカブシキガイシャ	名詞サ変	
ろっかしょむら	ロッカショムラ	名詞サ変	
ろぼっと	ﾛﾎﾞｯﾄ	名詞	
ろりっぷ	ロリップ	名詞サ変	
ろんぐ	ﾛﾝｸﾞ	名詞サ変	
わいやーそー	ワイヤーソー	名詞サ変	
わかまつえいじ	ワカマツエイジ	名詞サ変	
わっくす	ﾜｯｸｽ	名詞	
わっくすや	ワックス→	名詞	
わっくすはぎ	ワックス剥ぎ	名詞サ変	
わんめも	ワンメモ	名詞サ変	
わんやさんふじんかいいん	ワンヤサンフジンカイイン	名詞サ変	
ん	ン	名詞サ変	
あき	亜喜	名詞	
あそう	阿曽	姓	
わるいなど	悪い等	名詞	
やすくし	安くし	動詞サ変	
やすが	安ヶ	名詞	
あんぜんこうか	安全考課	名詞サ変	
あんぜんたい	安全帯	名詞サ変	
あんぜんたいしよう	安全帯使用	名詞サ変	
あんどうはざま	安藤ハザマ	組織	
いかだと	以下だと	感動詞	
いじょうな	以上な	名詞	
いとう	伊嶋	姓	
いとうし	伊藤氏	名詞	
いいか	位以下	助数詞	
いいか	位以下	名詞	
いちず	位置図	接尾一般	
いちず	位置図	名詞	
いちめい	位置名	接尾一般	
いちめい	位置名	名詞	
いしょうず	意匠図	名詞	
ためしよう	為使用	名詞サ変	
いじょうとう	異常等	名詞	
いどうとう	異動等	名詞	
いせつや	移設→	名詞	
いどうや	移動→	名詞	
いどうすること	移動する事	名詞	
いどうか	移動可	名詞	
いどうでき	移動出来	動詞一段	
いほう	移報	名詞サ変	
いほうていし	移報停止	名詞サ変	
ちがいたな	違い棚	名詞	
いりょうほうじん	医療法人	名詞	
いきす	域す	動詞サ変	
いちまる	一○	名詞	
かずとし	一寿	名	
いっちしたとき	一致した時	名詞	
みつひろ	允浩	名	
ひっこしび	引越し日	名詞	
ひきつぎかい	引継会	名詞	
ひきぬきりょく	引抜き力	名詞	
あめがかり	雨掛かり	名詞	
うんてんしゃや	運転者→	名詞	
うんぱんこう	運搬工	名詞	
ひでまる	英○	名詞	
えいかく	英角	名詞	
えいきょう	衛協	名詞	
えいせいしゃ	衛生社	名詞	
えいほう	衛法	名詞	
えきから	駅～	感動詞	
えきや	駅→	名詞	
えんかい	縁塊	名詞	
えんせきはしきちない	縁石は敷地内	名詞	
えんぎり	縁切り	名詞サ変	
えんきりぶ	縁切り部	名詞	
えんちゅう	遠忠	名詞	
えんびかびにる	塩ビ化ビニル	名詞	
おういんや	押印→	名詞	
おういんか	押印可	名詞	
よことも	横共	名詞	
よこきん	横筋	名詞	
おうだんか	横断可	名詞	
よこばり	横張	姓	
よこひ	横比	名詞サ変	
よこぶき	横葺き	名詞	
きせやま	黄瀬山	姓	
きせやま	黄瀬山	地名	
おくがいばん	屋外盤	名詞	
おくがいばんとう	屋外盤等	接尾一般	
やねにの	屋根に載	動詞ラ行五段	
やねとそう	屋根塗装	名詞サ変	
したや	下→	名詞	
さげること	下げる事	名詞	
したさん	下さん	接尾一般	
げやじょうぶ	下屋上部	名詞	
しもかわべ	下河邉	姓	
かきまちがえ	下記間違え	名詞	
かききのう	下記機能	名詞サ変	
したごころ	下心	接尾一般	
したごころ	下心	動詞サ変	
したじや	下地→	名詞	
かりかいこう	仮開口	名詞サ変	
かせつざい	仮設材	名詞	
かりじき	仮敷き	名詞サ変	
なんでもじかた	何で文字型	名詞	
かお	佳央	名	
けいじ	佳史	名	
かじゅうりつ	加重率	名詞	
かこめ	可※	名詞	
かとう	可とう	名詞サ変	
かとうがた	可とう形	名詞	
かだいとう	架台棟	名詞	
かわあい	河合	姓	
かきしよう	火気使用	名詞サ変	
かざんしつ	火山質	名詞	
かほう	火報	名詞サ変	
ひなし	火無し	名詞	
かじょうかき	箇条書き	助数詞	
かじょうかき	箇条書き	名詞サ変	
はなまる	花まる	名詞	
にこぼれ	荷こぼれ	名詞	
におろし	荷降ろし	名詞サ変	
にとり	荷取り	名詞サ変	
かだい	荷台	助数詞	
かだい	荷台	名詞	
かだいてん	課題点	名詞	
みやこ	雅子	名	
かいしゃく	介しゃく	名詞形動	
かいたいや	解体→	名詞	
かいたいか	解体可	名詞	
かいたいざい	解体材	名詞	
かいたいはんしゅつ	解体搬出	名詞サ変	
かいたいよう	解体用	名詞	
かいどくでき	解読出来	動詞一段	
かいかける	回×	感動詞	
かいしゅうしつ	回収室	名詞	
かいしゅう	回集	助数詞	
かいそうひ	回送費	名詞	
かいていど	回程度	名詞	
かいとうしゃ	回答社	名詞	
かいめ	回目	名詞	
かいと	魁斗	名	
えびつか	海老束	名詞	
かいせんや	開栓→	名詞	
かいせんとどけ	開栓届	名詞	
かいから	階～	感動詞	
かいとも	階共	名詞	
かいたてや	階建屋	名詞	
かいしょだな	階書棚	名詞	
かいゆか	階床	名詞	
かいしょうじ	階障子	名詞	
かいせんじょう	階洗浄	名詞サ変	
かいそうよう	階層用	助数詞	
かいそうよう	階層用	名詞	
かいだんとう	階段棟	名詞	
かいちか	階地下	名詞	
かいろうか	階廊下	名詞	
はずしや	外し→	名詞	
がいこうぶ	外構部	名詞	
がいぎょう	外行	接尾一般	
がいぎょう	外行	名詞	
がいへきはり	外壁張り	名詞サ変	
がけじょう	崖上	名詞	
がいとうがい	該当外	名詞	
がいとうき	該当期	名詞	
かくけん	各件	名詞	
かくはいき	各廃棄	名詞サ変	
かくもん	各門	名詞	
かくにんや	確認→	名詞	
かくにんしよう	確認仕様	名詞	
かくほけん	確保件	名詞	
かくほでき	確保出来	動詞一段	
がくよう	額用	接尾一般	
がくよう	額用	名詞	
かけご	掛け後	名詞	
わりましりつ	割増し率	助数詞	
わりましりつ	割増し率	名詞	
かつどう	滑動	名詞サ変	
かつどうし	滑動し	動詞サ変	
かのうや	叶屋	姓	
かりたそうごう	刈田総合	名詞サ変	
かりたそうごう	刈田綜合	名詞サ変	
かんそうや	乾燥→	名詞	
まきし	巻氏	接尾一般	
まきし	巻氏	名詞	
かんこうけい	完工計	名詞	
かんこうだか	完工高	名詞	
かんこうび	完工日	名詞	
かんこうよう	完工用	名詞	
かんこうだか	完甲高	名詞形動	
かんりょうよう	完了用	名詞	
かんぶ	環部	名詞	
かんりしゃさま	監理者様	名詞	
かんしいん	看視員	名詞	
かんばんとう	看板棟	名詞	
かんいち	管位置	名詞サ変	
かんきょう	管教	名詞	
かんこうぎょう	管工業	名詞	
かんこうじ	管工事	名詞サ変	
かんちょうさ	管調査	名詞サ変	
かんぶつ	管物	名詞	
かんりはじめ	管理始め	名詞サ変	
かんりち	管理値	名詞	
かんりち	管理地	名詞	
かんりとう	管理灯	名詞	
かんだい	貫大	助数詞	
かんだい	貫大	名詞	
かんげんとう	還元棟	名詞	
まにあわないため	間に合わない為	名詞	
かんごと	間毎	接尾一般	
かんごと	間毎	名詞	
まみ	間未	接頭語	
かんけいや	関係→	名詞	
かんけいしゃがい	関係者外	名詞	
まるひで	丸英	名詞	
まるかね	丸金	名詞	
まるけん	丸建	名詞	
きしの	岸野	名詞	
いわてこうじょう	岩手工場	名詞	
ねがうや	願う→	名詞	
きじゅんき	基準期	名詞	
きそした	基礎下	名詞	
きそしよう	基礎使用	名詞サ変	
きちぶ	基地部	名詞	
きほんは	基本歯	名詞	
きせつひん	既設品	名詞	
きばらいだか	既払高	名詞	
きから	期～	感動詞	
きげんや	期限→	名詞	
きこうじ	期工事	名詞サ変	
きしゅぶん	期首分	名詞	
きすう	期数	数	
きがわり	期代わり	接尾一般	
きがわり	期代わり	助数詞	
きがわり	期代わり	動詞サ変	
きごと	期毎	接尾一般	
きごと	期毎	助数詞	
きごと	期毎	名詞	
きしゅ	期繻	名詞	
きしゅぶん	期繻分	名詞	
ききおよび	機器及び	接続詞	
きせい	機世	接尾一般	
たける	毅	名	
きこう	気口	名詞	
きちゅうかいへいき	気中開閉器	名詞	
きちょうだい	記帳台	名詞	
きにゅうや	記入→	名詞	
きにゅうれい	記入例	名詞	
てるみち	輝道	名	
かめじ	亀治	名	
かめじろう	亀治朗	名詞	
ぎしろう	儀四郎	名	
よしまる	義○	名詞	
きくの	菊乃	名	
ひさいち	久一	姓	
ひさいち	久一	名	
ひさみつ	久晃	名	
ひさかずゆき	久和幸	名	
やすむよう	休む用	名詞	
きゅうこう	休工	接尾一般	
きゅうこうちゅう	休工中	接尾一般	
きゅうこうちゅう	休工中	名詞	
みやしょう	宮商	名詞	
みやぎけんせんだいし	宮城県仙台市	地名	
くみとりしき	汲取り式	名詞	
きゅうかん	級管	名詞	
きゅうかんこうじ	級管工事	名詞サ変	
きゅうきがわ	給気側	名詞	
きゅうはいきとう	給排気塔	名詞	
きゅうはいきとうや	給排気塔→	名詞	
きゅうはいきとう	給排気棟	名詞	
きゅうよや	給与→	名詞	
きゅうず	旧図	名詞	
いしつ	居室	名詞	
きょかされたこと	許可された事	名詞	
きょうつうざい	共通材	名詞	
きょうゆうするなど	共有する等	名詞	
きょうぎよう	協議用	名詞	
きょうりん	協林	名詞	
きょういくしょう	教育証	名詞サ変	
はしずめ	橋爪	姓	
はしもとや	橋本→	名詞	
こうぎょうかぶ	興業(株)	名詞	
まがりまで	曲りまで	名詞	
きょくつき	極付	助数詞	
たまがけ	玉掛け	名詞サ変	
たまがけしゃ	玉掛け者	名詞	
たまね	玉根	名詞	
きりだ	桐田	姓	
きんしよう	禁止用	名詞	
きんけつ	筋結	名詞	
きんけつを	筋結を	感動詞	
きんけつ	緊結	名詞	
ちかさと	近郷	姓	
かねいち	金市	姓	
かねいち	金市	名	
くにお	九二雄	名	
くいきとう	区域等	名詞	
くたい	躯体	名詞	
くうかん	空缶	名詞	
からよう	空用	名詞	
ずみ	隅	名詞	
ほりおこしていたとき	掘り起こしていた時	名詞	
くりざき	栗﨑	姓	
くわの	鍬野	姓	
がたこう	型鋼	名詞	
けいやくこうきがい	契約工期外	名詞	
けいやくでき	契約出来	動詞一段	
けいじや	掲示→	名詞	
けいじもの	掲示物	名詞	
けいりん	桂林	名詞	
けいりんじび	桂林耳鼻	名詞	
けいしーと	系シート	名詞	
けいとうごと	系統毎	名詞	
つなぎこみ	繋ぎ込み	名詞	
けいかくしょや	計画書→	名詞	
けいさんや	計算→	名詞	
けいびじょ	警備所	名詞	
けいほうばん	警報盤	名詞	
けいりょうだな	軽量棚	名詞	
けっていや	決定→	名詞	
けっていごと	決定毎	名詞	
がつから	月～	感動詞	
つきこめ	月※	名詞	
つきじ	月次	助数詞	
がつまつ	月松	名詞	
がつぶん	月文	名詞	
つきまつ	月末	助数詞	
つきまつ	月末	名詞	
けんどう	件どう	名詞サ変	
けんこうじ	件工事	名詞サ変	
たけひろ	健広	名	
けんしん	健診	名詞	
けんたいきょう	健退共	名詞	
けんりゅう	健隆	名	
けんにんか	兼任可	名詞	
たてとう	建て等	名詞	
たてぐてん	建具店	名詞	
けんこう	建工	名詞	
けんしょう	建硝	名詞	
けんせつや	建設→	名詞	
けんそう	建装	名詞	
けんちゅう	建柱	名詞	
たてい	建入	動詞ラ行五段	
けんぱん	建販	名詞	
たてものめい	建物名	名詞	
たてわく	建枠	名詞	
けんさひょう	検査票	名詞	
けんとうすること	検討する事	名詞	
けんから	県～	感動詞	
みたしよう	見た仕様	名詞	
みえがかり	見栄掛かり	名詞	
みつもりしょ	見積り書	名詞サ変	
みつもりよう	見積り用	名詞	
みつもりしょ	見積書	名詞サ変	
みつもりしょや	見積書→	名詞	
つかったよう	遣った用	名詞	
もとうけがた	元請け方	名詞	
わら	原	名詞	
げんりょうか	減量課	名詞	
みなと	源	姓	
みなと	源	名	
げんたん	源反	接尾一般	
げんばじむしょ	現場事務所	名詞	
げんかいひ	限界比	名詞サ変	
ふるいなど	古い等	名詞	
み	己	名	
とがせ	戸ヶ瀬	姓	
とだけ	戸竹	名詞	
はかまだし	袴田氏	名詞	
いらこ	五十子	姓	
ごじょう	五城	名詞	
ごじょうもく	五城目	接尾一般	
ごじょうもく	五城目	名詞サ変	
ごゆう	五勇	名詞	
ごいちらん	後一覧	名詞サ変	
ごかいとう	後回答	名詞サ変	
ごかくにん	後確認	名詞サ変	
ごがく	後学	接尾一般	
ごがく	後学	名詞	
ごきにゅう	後記入	名詞サ変	
ごころ	後頃	名詞	
ごしよう	後使用	名詞サ変	
ごじっし	後実施	名詞サ変	
ごしゅうせい	後修正	名詞サ変	
ごじょうほう	後情報	名詞	
こうしんじ	後進時	名詞	
ごそうしん	後送信	名詞サ変	
ごついか	後追加	名詞サ変	
ごとうろく	後登録	名詞サ変	
ごにゅうりょく	後入力	名詞サ変	
ごもじ	後文字	接尾一般	
ごもじ	後文字	名詞	
ごへんしん	後返信	名詞サ変	
ごほうこく	後報告	名詞サ変	
ごようじょう	後養生	名詞サ変	
ごれんらく	後連絡	名詞サ変	
こうていぶん	光庭分	名詞	
こうきょうちゅう	公共柱	名詞	
こうざい	公斉	名詞	
きみのぶ	公宣	名	
こうせいとう	厚生棟	名詞	
このむ	好	名	
よしとく	好徳	名	
あなあけ	孔明け	名詞サ変	
たかき	孝樹	名	
こうき	工器	接尾一般	
こうきちゅう	工期中	名詞	
こうぎょうかぶ	工業(株)	名詞	
こうぐとう	工具等	名詞	
こうざん	工残	名詞	
こうじなさそう	工事なさそう	名詞形動	
こうじか	工事化	名詞サ変	
こうじきん	工事金	名詞	
こうじしよう	工事使用	名詞サ変	
こうじとう	工事灯	名詞	
こうじとう	工事等	名詞	
こうじないよう	工事内容	名詞	
こうじめいや	工事名→	名詞	
こうじめいなど	工事名等	名詞	
こうしゅべつ	工種別	名詞形動	
こうしゅめい	工種名	名詞	
こうじょうせん	工場扇	名詞	
ひろつな	広綱	名詞	
ひろのり	広則	名詞	
こうようかい	広葉会	名詞	
ひろでんしゃ	弘電社	名詞	
こうたいあり	抗体有り	名詞	
ひかえしじ	控え支持	名詞サ変	
ひかえしじてん	控え支持点	名詞	
ひかり	晃	名	
あきよし	晃喜	名	
こうしつ	更室	名詞	
くいのこ	杭残	動詞サ行五段	
くいとう	杭等	名詞	
こうぞうじょう	構造畳	名詞	
こうぞうなど	構造等	名詞	
こうめんふう	構面風	名詞形動	
こうもん	港門	名詞	
たかゆき	考行	名	
こうていや	肯定→	名詞	
あらいえ	荒家	姓	
ぎょうや	行→	名詞	
ぎょうしか	行しか	助数詞	
ぎょうしか	行しか	名詞	
ぎょうじょうぶ	行上部	接尾一般	
ぎょうじょうぶ	行上部	助数詞	
ぎょうじょうぶ	行上部	名詞	
こうぎょうかぶ	鉱業（株）	名詞	
こうはんふき	鋼板葺き	名詞	
こうよう	鋼用	名詞	
おろしたとき	降ろした時	名詞	
こうしんせい	項申請	名詞サ変	
たかさなど	高さ等	名詞	
たかゆき	高行	名詞	
たかわ	高輪	姓	
ごうや	号→	名詞	
あいばん	合い番	名詞サ変	
あいずしゃ	合図者	名詞	
かつゆき	克つ幸	名詞	
かつより	克頼	名	
こしぶ	腰部	名詞	
こんしゅうちゅうや	今週中→	名詞	
こんしゅうまつから	今週末～	感動詞	
こんのさん	今野さん	名詞	
ねがらみ	根がらみ	名詞	
ねた	根太	名詞	
ねきうち	根木内	姓	
さくままで	佐久間まで	名詞	
さとういんてりあ	佐藤インテリア	名詞	
さとうし	佐藤氏	名詞	
さとうじゅんこ	佐藤淳子	人名	
さがら	佐柄	姓	
さがらや	佐柄→	名詞	
さきしよう	左記仕様	名詞	
さきしき	左記式	名詞	
さしこみよう	差し込み用	名詞	
さしこみずみ	差込済み	名詞	
さよう	差用	名詞	
さいけ	砂池	名詞	
さいそうしんでき	再送信出来	動詞一段	
さいえん	最縁	名詞	
さいしんき	最新期	名詞	
さいち	最遅	名詞	
さいていげん	最低現	接頭語	
さいしゅや	採取→	名詞	
さいだん	採暖	名詞	
さいようきゅうよ	採用給与	名詞サ変	
ざい	済	名	
ずみや	済み→	名詞	
さいぼう	災防	名詞	
さいせきや	砕石→	名詞	
さいせきか	砕石化	名詞サ変	
ざいにあげ	材荷揚	名詞サ変	
ざいにあげ	材荷揚げ	名詞サ変	
ざいこう	材工	接尾一般	
ざいめい	材名	接尾一般	
ざいめい	材名	名詞	
ざいりょうのうき	材料納期	名詞	
さかたし	坂田氏	名詞	
さぎょうか	作業可	名詞	
さぎょうあけ	作業明け	名詞サ変	
さくずや	作図→	名詞	
さくせいや	作成→	名詞	
さくせいしよう	作成使用	名詞サ変	
さくせいなど	作成等	名詞	
さくじょや	削除→	名詞	
さくじょすること	削除する事	名詞	
さくじょご	削除後	名詞	
さつえいか	撮影可	名詞	
ざつこう	雑工	名詞	
みうらし	三浦氏	名詞	
さんえん	三塩	名詞	
さんこうしょうてん	三幸商店	名詞	
みしろ	三城	姓	
さんしょくとう	三色灯	名詞	
さんよう	三要	名詞サ変	
やまいち	山位置	名詞サ変	
やまがたや	山形→	名詞	
さんすいき	山水機	名詞	
やまだし	山田氏	名詞	
さんし	散し	動詞サ変	
さんす	散す	動詞サ変	
さんすいしゃ	散水者	名詞	
さんすいちゅう	散水中	名詞	
さんぶつ	散物	名詞	
さんぱいひ	産廃費	名詞	
さんぱいよう	産廃用	名詞	
のこさないの	残さない野	名詞	
ざんび	残火	名詞	
しきりしょとう	仕切書等	名詞	
しようとう	仕様等	名詞	
しようしきざい	使用資機材	名詞	
しようしょ	使用書	名詞サ変	
つぐ	嗣	名	
しどうがわ	市道側	名詞	
しめいふりがな	市名フリガナ	名詞	
しのぶ	志信	姓	
しのぶ	志信	名	
おもってい	思ってい	動詞一段	
しじいがい	指示以外	名詞	
しじりつ	指示率	名詞	
していき	指定期	名詞	
していしょく	指定色	名詞	
していないよう	指定内容	名詞	
ししょさま	支所様	名詞	
しはらいだか	支払い高	名詞	
しほこうや	支保工→	名詞	
せこうするや	施工する→	名詞	
せこうはん	施工班	名詞	
せこうはんすう	施工班数	接尾一般	
せこうはんすう	施工班数	助数詞	
せこうほうしん	施工方針	名詞	
どめすること	止めする事	名詞	
しめいかな	氏名カナ	名詞	
ししょばこしつ	私書箱室	名詞	
しせつちゅう	私設柱	名詞	
わたくしびょう	私病	名詞	
しにんしょうがい	視認障害	名詞	
ためしぶき	試し吹き	名詞	
しけんでき	試験出来	動詞一段	
しかくめい	資格名	名詞	
しりょうや	資料→	名詞	
じぎょうちょう	事業長	接尾一般	
じぎょうちょう	事業長	名詞	
じことう	事故等	名詞	
にすがたや	似姿→	名詞	
じこう	字溝	助数詞	
あざめい	字名	名詞	
じから	時～	感動詞	
じや	時→	名詞	
じかいし	時開始	名詞サ変	
じきぼう	時希望	名詞サ変	
じけい	時計	接尾一般	
じけい	時計	助数詞	
じけい	時計	名詞	
とけいだい	時計代	名詞	
じしよう	時使用	名詞サ変	
じしゃない	時社内	名詞	
じた	時他	名詞	
じたいしゃ	時退社	名詞サ変	
じたんか	時単価	名詞	
じついか	時追加	名詞サ変	
じとう	時等	接尾一般	
じとう	時等	助数詞	
じほどう	時歩道	名詞	
じ	次	名	
じぎょうしゃ	次業者	名詞	
じかほう	自火報	名詞サ変	
じたくから	自宅～	感動詞	
ときた	蒔田	姓	
かこき	鹿子木	姓	
かじまや	鹿島→	名詞	
かない	鹿内	姓	
しきうつし	式写し	名詞	
しつじくん	執事くん	名詞	
しつめい	室名	接尾一般	
しつめい	室名	助数詞	
しつめい	室名	名詞	
しつじゅんか	湿潤化	名詞サ変	
しつぎとう	質疑等	名詞	
じっしひょう	実施表	名詞サ変	
じっしつげんか	実質原価	名詞	
じつちょう	実長	名詞	
しゃかん	写管	名詞	
しゃかんや	写管屋	名詞	
しゃしんや	写真→	名詞	
しゃいんを	社印を	感動詞	
しゃへいか	者へ以下	接尾一般	
しゃへいか	者へ以下	助数詞	
しゃへいか	者へ以下	名詞	
しゃよう	者用	接尾一般	
しゃよう	者用	助数詞	
しゃよう	者用	名詞	
しゃことう	車庫棟	名詞	
くるまどめや	車止め→	名詞	
しゃろ	車路	接尾一般	
しゅまき	主巻き	名詞サ変	
しゅかんか	主管課	名詞	
とりあいや	取り合い→	名詞	
とりあつかいじ	取扱時	名詞	
とりきめぶん	取極め分	名詞	
とりこみよう	取込み用	名詞	
とりこみあん	取込案	名詞サ変	
とりこみずみ	取込済み	名詞	
てもととう	手元灯	名詞	
てこ	手古	接頭語	
てがきか	手書き可	名詞	
うけわたしじ	受け渡し時	名詞	
うけばり	受け梁	名詞	
じゅちゅうがく	受注学	名詞	
じゅちゅうじ	受注時	名詞	
しゅうご	周吾	姓	
しゅうご	周吾	名	
しゅうれい	周例	助数詞	
しゅうれい	周例	名詞	
しゅうえい	修永	名	
しゅうせいしゃ	修正者	名詞	
しゅうせいぶん	修正分	名詞	
ひでと	秀斗	名	
ひでと	秀都	名	
あきたや	秋田→	名詞	
あきたけんあきたし	秋田県秋田市	地名	
しゅうりょうや	終了→	名詞	
しゅうすいき	集水器	名詞	
じゅうきとう	什器等	名詞	
じゅうたくした	住宅下	名詞	
あつし	充	名	
たてかける	縦×	感動詞	
たてそーと	縦ソート	名詞サ変	
たてざい	縦材	名詞	
たてばり	縦貼り	名詞サ変	
じゅうえん	重円	助数詞	
じゅうえん	重円	名詞サ変	
じゅうかん	重管	名詞	
じゅうきとう	重機等	名詞	
しげたつ	重立	姓	
でないや	出ない→	名詞	
でいりすること	出入りする事	名詞	
でいりぐちや	出入り口→	名詞	
できなかったため	出来なかった為	名詞	
できるよう	出来る様	名詞形動	
しゅつりょくじ	出力次	名詞	
としひら	俊平	名	
としよし	俊良	名	
じゅんすいよう	純水用	名詞	
じゅんかいじ	巡回時	名詞	
じゅんじした	順次下	名詞	
しょりや	処理→	名詞	
しょりざい	処理材	名詞	
はつはつ	初発	接尾一般	
はつはつ	初発	名詞	
しょけいひ	所経費	名詞	
かいてみ	書いて見	動詞一段	
かいてしま	書いて閉ま	動詞ラ行五段	
しょとう	書当	名詞	
しょるいだな	書類棚	名詞	
しょるいへん	書類編	名詞	
じょきょや	除去→	名詞	
じょきょざい	除去材	名詞	
じょそうご	除草後	名詞	
かつまた	勝又	名詞	
かつまた	勝又	副詞	
しょうけん	商建	名詞	
しょうけん	商研	接尾一般	
しょうさいず	小サイズ	名詞	
しょうかいぎしつや	小会議室→	名詞	
おだしまや	小田島→	名詞	
おだしまえいじ	小田島英嗣	人名	
こばり	小梁	名詞	
しょうしょうけい	少々計	名詞	
まさ	庄	名	
ゆかないそう	床内装	名詞サ変	
ゆかばん	床版	名詞	
ゆかめんとう	床面等	名詞	
しょうこうじ	昇降時	名詞	
しょうこうじゅん	昇降順	名詞	
しょうこうちゅう	昇降中	名詞	
しょうこうぶ	昇降部	名詞	
しょうこうよう	昇降用	名詞	
しょうじろう	昇二郎	名	
あきひさ	昌久	名	
あきひろ	昌宏	名	
あきらや	昌也	名詞	
あきひろ	昭浩	名	
しょうかせん	消化栓	名詞	
しょうかはん	消火班	名詞	
しょうとうでき	消灯出来	動詞一段	
しょうぼうかんし	消防監視	名詞サ変	
あゆむ	渉	名	
てるみち	照道	名	
しょうめいちゅう	照明柱	名詞	
しょうぼう	祥房	名詞	
しょうばんごう	証番号	名詞	
しょうさいもした	詳細も下	名詞	
しょうさいず	詳細図	名詞	
しょうがいとう	障害灯	接尾一般	
うえから	上~	感動詞	
じょうが	上ヶ	名詞	
じょうきいがい	上記以外	名詞	
じょうきいち	上記位置	名詞サ変	
じょうきしよう	上記仕様	名詞	
じょうきしき	上記式	名詞	
あげつま	上妻	姓	
じょうさい	上載	名詞	
うわがきか	上書き可	名詞	
うえだし	上田氏	名詞	
かみどうや	上堂→	名詞	
かみざき	上﨑	姓	
のりこみび	乗り込み日	名詞	
たたみした	畳下	名詞	
のばしぼう	伸ばし棒	名詞	
のぶいち	伸一	名	
しんめいさんぎょう	伸名産業	名詞	
しんめい	伸明	名詞	
しんめいさんぎょう	伸明産業	名詞	
した	信太	姓	
しんがき	新垣	姓	
しんがき	新垣	名	
しんのう	新納	姓	
しんさわ	新澤	名詞	
まこ	真心	名	
かみぶん	神文	名詞	
かみやす	神保	姓	
しんいち	芯位置	名詞サ変	
しんゆか	芯床	名詞	
しんりょういん	診療院	名詞	
しんかい	進化移	名詞	
にんいん	人員	名詞	
にんじ	人時	名詞	
ひとたんい	人単位	名詞	
ひと	仁	名詞	
じんかい	仁会	名詞	
じんの	塵の	名詞	
すかた	諏方	姓	
ずかい	図改	名詞	
ずめんかん	図面間	名詞	
ふきだしぐち	吹出口	名詞	
すいぼうてい	水防堤	名詞	
すうりょうけい	数量計	名詞	
ずり	摺	名詞	
ぜせいや	是正→	名詞	
せいぎょでき	制御出来	動詞一段	
せいしよう	制止用	名詞	
せいこう	性鋼	名詞	
なるが	成ヶ	名詞	
せいけい	成形	名詞	
せいけいばん	成形板	接尾一般	
なりはら	成原	姓	
せいりつひょう	成立票	名詞	
せいすうか	整数化	名詞サ変	
せいせん	整線	名詞	
せいせんす	整線す	動詞サ変	
せいりまえ	整理前	接頭語	
せいりひょう	整理表	名詞サ変	
しょうじ	正爾	名	
せいしきしよう	正式仕様	名詞	
しょうた	正大	名	
せいりん	正倫	名	
しょうでん	正傳	姓	
せいる	清琉	名詞	
もりおかや	盛岡→	名詞	
もりおかししも	盛岡市下	名詞	
もりおかしみなみおおどおり	盛岡市南大通	地名	
もりあいや	盛合→	名詞	
せいさんぶん	精算分	名詞	
さとる	聖	名	
せいひんこ	製品庫	名詞	
にしや	西→	名詞	
にしとう	西棟	名詞	
せいと	誠人	名	
せいきゅうないよう	請求内容	名詞	
あおじ	青字	名詞	
あおもりけん	青森県	名詞	
あおばくいちばんちょう	青葉区一番町	地名	
さいとうし	斉藤氏	名詞	
いしざい	石材	名詞	
いしよう	石用	名詞	
つみこみや	積み込み→	名詞	
つみこみや	積込み→	名詞	
つみこみよう	積込み用	名詞	
せきすいめでぃかる	積水メディカル	名詞形動	
あかなど	赤等	名詞	
きりこ	切り粉	名詞	
せつだんすること	切断する事	名詞	
きりぬきよう	切抜き用	名詞	
せっちのため	設置の為	名詞	
せっちでき	設置出来	動詞一段	
せつめいや	説明→	名詞	
せんだいや	仙台→	名詞	
せんだいし	仙台市	名詞	
せんだいしょうこうかいぎしょ	仙台商工会議所	名詞	
せんだいぶん	仙台分	名詞	
さきはじめ	先始め	接尾一般	
さきはじめ	先始め	名詞サ変	
さきかわ	先川	姓	
さきよう	先用	接尾一般	
さきよう	先用	名詞	
せんげん	千減	名詞サ変	
せんゆうよう	占有用	名詞	
せんぶん	栓文	名詞	
いずみざわ	泉澤	名詞	
せんざいだい	洗剤代	名詞	
せんとらっぷ	線トラップ	名詞サ変	
せんなし	線無し	接尾一般	
せんなし	線無し	名詞	
せんよう	線用	接尾一般	
せんよう	線用	名詞	
せんりょうか	線量下	名詞	
せんりょうした	線量下	名詞	
せんりょうまえ	線量前	接頭語	
せんたくするや	選択する→	名詞	
せんていでき	選定出来	動詞一段	
まえか	前可	名詞	
まえだか	前高	名詞	
ぜんじ	前司	名詞	
ぜんかくか	全角化	名詞サ変	
ぜんこうき	全工期	名詞	
ぜんこうじ	全工事	名詞サ変	
ぜんしょちょう	全所長	名詞	
そえんしゃ	疎遠者	名詞	
あらりがく	粗利額	名詞	
そしきちょう	組織長	名詞	
くみたてまえ	組立前	名詞	
そうび	創美	名詞	
そうびしゃ	創美社	接尾一般	
そうびしゃ	創美社	名詞	
そうこか	倉庫化	名詞サ変	
そうことう	倉庫棟	名詞	
そうが	層が	接続詞	
そうあたり	層当たり	助数詞	
そうあたり	層当たり	名詞サ変	
そうごと	層毎	接尾一般	
そうごと	層毎	助数詞	
そうごと	層毎	名詞	
そうじ	惣治	名	
そうていきゅうよ	想定給与	名詞サ変	
そうていひょう	想定表	名詞サ変	
かもんぜき	掃部関	姓	
そうさでき	操作出来	動詞一段	
そうそう	相双	名詞	
そうぞくされたところ	相続された所	名詞	
まどぐちまわり	窓口まわり	名詞サ変	
そうけい	総警	名詞	
そうこうじ	総工事	名詞サ変	
そうこうじひ	総工事費	名詞	
そうろう	聡朗	名	
そうき	草来	動詞カ変	
そうふや	送付→	名詞	
ますこ	増子	姓	
ますこ	増子	名	
ぞうへい	造塀	名詞	
そっこうした	側溝下	名詞	
そくだい	則第	接頭語	
あしばや	足場→	名詞	
ぞんち	存置	名詞	
そんしょう	損焼	名詞	
たこうじ	他工事	名詞サ変	
うちあわせよう	打ち合わせ用	名詞	
うちあわせず	打合せ図	名詞	
たいこうき	体工期	名詞	
たいおうき	対応期	名詞	
たいおうでき	対応出来	動詞一段	
たいおうできないや	対応出来ない→	名詞	
たいしょすること	対処する事	名詞	
たいしょういち	対象位置	名詞サ変	
たいしょうち	対象値	名詞	
たいしょうれつ	対象列	名詞	
たいほう	対法	接尾一般	
たいほう	対法	名詞	
たいとうか	耐透過	名詞サ変	
まちや	待ち→	名詞	
がえなど	替え等	接尾一般	
がえなど	替え等	名詞	
たいいき	退域	名詞	
たいこうす	退構す	動詞サ変	
たいこうぞう	退構造	名詞	
たいこうぞうじ	退構造時	名詞	
だいがえあん	代替え案	名詞サ変	
だいむしゃ	代務者	名詞	
だいようか	代用可	名詞	
だいりでき	代理出来	動詞一段	
だいびる	台ビル	接尾一般	
だいびる	台ビル	助数詞	
だいびる	台ビル	名詞	
だいこうせい	台校正	名詞サ変	
だいしよう	台使用	名詞サ変	
だいぜんご	台前後	名詞サ変	
だいちゅう	台中	接尾一般	
だいちゅう	台中	助数詞	
だいちゅう	台中	名詞	
だいまる	大○	名詞	
だいいち	大1	数	
だいけい	大けい	名	
たいしたこと	大した事	名詞	
おおばら	大バラ	動詞サ行五段	
おおばらし	大ばらし	名詞	
たいかいじ	大会時	名詞	
おおえ	大恵	姓	
だいご	大吾	名	
だいしん	大信	名詞サ変	
おおどおりにし	大通西	姓	
おおどおりにし	大通西	地名	
たいなん	大南	名詞	
だいばん	大盤	接尾一般	
だいばん	大盤	助数詞	
だいほう	大邦	名詞	
たいほく	大北	名詞	
たいようびる	大洋ビル	名詞	
だいわ	大輪	姓	
だいいちい	第１位	名詞	
だいに	第2	数	
だいいちかいそう	第一階層	名詞	
だいいちこうさくとう	第一工作棟	名詞	
だいいちだん	第一段	名詞	
たんとう	単灯	名詞	
たんとうや	担当→	名詞	
みじか	短	名詞	
ばたかく	端角	接尾一般	
ばたかく	端角	名詞	
だんせいなど	弾性等	名詞	
だんねつしよう	断熱仕様	名詞	
だんちゅう	段中	名詞	
あたいか	値化	名詞サ変	
ちひょう	値表	接尾一般	
ちひょう	値表	名詞サ変	
ちいきしょく	地域職	名詞	
ちかがわ	地下側	名詞	
じず	地図	名詞	
ちちゅうばり	地中梁	名詞	
じは	地這	動詞ワ行五段	
ともひで	智秀	名	
いけや	池→	名詞	
おきかえよう	置き換え用	名詞	
おきばしよう	置き場仕様	名詞	
たけはらや	竹原屋	名詞	
ちゃくしゅでき	着手出来	動詞一段	
ちゃくにんしゃ	着任者	名詞	
ちゅうや	中→	名詞	
ちゅうがいしょうこう	中外商工	名詞	
ちゅうかんひょう	中間表	名詞サ変	
なかかるまい	中軽米	名詞	
なかさん	中桟	名詞	
ちゅうしや	中止→	名詞	
ちゅうじゅんから	中旬～	感動詞	
ちゅうだんするため	中断する為	名詞	
ちゅうわとう	中和等	名詞	
ちゅうれい	昼礼	名詞サ変	
ちゅうれいとう	昼礼等	名詞	
はしらじょう	柱上	名詞	
ちゅうでん	注伝	名詞	
ちゅうばん	注番	名詞サ変	
とめお	駐め置	動詞カ行五段	
ちゅうしゃでき	駐車出来	動詞一段	
ためます	貯め桝	名詞	
ちょうがけ	丁掛け	助数詞	
ちょうがけ	丁掛け	動詞サ変	
ちょうれいじ	朝礼時	名詞	
ちょうさや	調査→	名詞	
ちょうさいらい	調査依頼	名詞サ変	
ちょうさぎょう	調査行	名詞	
ちょうさたいしょう	調査対象	名詞	
ちょうせいや	調整→	名詞	
ちょうせいざい	調整材	名詞	
ちょうせいすう	調製数	名詞	
ちょうせいすう	長整数	名詞	
ながひこ	長彦	名	
なお	直央	名	
じかうち	直打ち	名詞サ変	
じかうちだ	直打ちだ	感動詞	
つどめ	津留	姓	
おいき	追木	姓	
とおりしん	通り真	名詞	
つうかがた	通貨型	名詞	
つうこう	通工	接尾一般	
つうこう	通工	助数詞	
つうろとう	通路等	名詞	
つづりよう	綴り用	名詞	
つりおろし	吊り降ろし	名詞サ変	
つりこみ	吊り込み	名詞	
つりあげ	吊り揚げ	動詞一段	
つるまで	吊るまで	名詞	
ていしゃこう	低車高	接尾一般	
ていしゃこう	低車高	名詞サ変	
さだに	貞二	数	
ていちゃく	定着	名詞	
ていたい	底体	名詞	
にわだ	庭田	名詞	
ていしゅつや	提出→	名詞	
ていしゅつすること	提出する事	名詞	
ていしゅつするよう	提出する用	名詞	
くぎうちき	釘打ち器	名詞	
てっきょや	撤去→	名詞	
てっきょすること	撤去する事	名詞	
てっこつとそう	鉄骨塗装	名詞サ変	
てつぞう	鉄造	名詞	
てっとうや	鉄塔→	名詞	
てんじょうした	天井下	名詞	
まとまっていないため	纏まっていない為	名詞	
はりつけないよう	貼り付け内容	名詞	
はりつけよう	貼付け用	名詞	
たむらけんせつ	田村建設	名詞サ変	
でんきばん	電気盤	名詞	
でんししょう	電子小	名詞	
でんせんかんしょう	電線干渉	名詞サ変	
でんわか	電話可	名詞	
とそうや	塗装→	名詞	
とそうとも	塗装共	名詞	
とそうけい	塗装計	名詞	
とそうしよう	塗装仕様	名詞	
わたしよ	渡し良	形容詞	
わたすや	渡す→	名詞	
とうろくしよう	登録使用	名詞サ変	
とどうふけんめい	都道府県名	名詞	
どあつ	度圧	名詞	
どごと	度毎	助数詞	
どごと	度毎	名詞	
どまや	土間→	名詞	
どきゅう	土休	接尾一般	
どきゅう	土休	動詞サ変	
どのうあり	土嚢有り	名詞	
どりょう	土量	接尾一般	
どりょう	土量	名詞	
たおれが	倒れが	接続詞	
たおれやす	倒れ易	形容詞	
とうかいや	倒壊→	名詞	
とうかいじ	倒壊時	名詞	
とうききゅう	冬季休	名詞サ変	
とうききゅうこう	冬季休工	接尾一般	
とうたい	塔体	名詞	
とうにゅうや	投入→	名詞	
ひがしや	東→	名詞	
とうかく	東角	名詞	
とうきょうとしんじゅくく	東京都新宿区	地名	
とうこう	東光	名詞	
とうどう	東藤	名詞	
とうほくしてん	東北支店	名詞	
とうほくせっけいしつ	東北設計室	名詞	
とうほくでんか	東北電化	名詞サ変	
ひがしめん	東面	名詞	
とうや	棟屋	接尾一般	
とうや	棟屋	助数詞	
とうとも	棟共	名詞	
とうぎょう	棟行	接尾一般	
とうぎょう	棟行	助数詞	
とうぎょう	棟行	名詞	
とうがわ	棟側	接尾一般	
とうがわ	棟側	助数詞	
とうがわ	棟側	名詞	
とうべつ	棟別	接尾一般	
とうべつ	棟別	助数詞	
とうべつ	棟別	名詞形動	
とうめい	棟名	接尾一般	
とうめい	棟名	助数詞	
とうめい	棟名	名詞	
ゆとう	湯藤	姓	
とうしき	灯式	接尾一般	
とうしき	灯式	名詞	
とうこうじ	等工事	名詞サ変	
つつみ	筒身	名詞	
つつだ	筒田	姓	
とういつすること	統一する事	名詞	
あたまから	頭～	感動詞	
おなじそう	同じ層	名詞	
どうしつざい	同質材	名詞	
どうにゅうしゃ	導入者	名詞	
とくひこ	徳彦	名	
とくあん	特安	名詞	
とくあんび	特安日	名詞	
とっきしよう	特記仕様	名詞	
とびこう	鳶工	名詞	
なお	那央	名	
ないの	内の	名詞	
ないがいとも	内外共	名詞	
うちふる	内古	接頭語	
うちふるし	内古氏	名詞	
うちしろや	内城→	名詞	
ないそうけい	内装系	名詞	
ないそうちょうふきつけ	内装調吹付	地名	
ないようのよう	内容の様	名詞形動	
ないよう	内用	接尾一般	
ないよう	内用	名詞	
みなみや	南→	名詞	
みなみうえのはらはいつ	南上ノ原ハイツ	名詞	
みなみとう	南棟	名詞	
みなみめん	南面	名詞	
にへい	二瓶	姓	
にちから	日～	感動詞	
にちや	日→	名詞	
ひした	日下	姓	
ひのした	日下	姓	
ひじ	日次	名詞	
にちじゅう	日十	数	
ひでき	日出喜	名	
にっちゅうたい	日中帯	名詞サ変	
びちょうせい	日調整	名詞サ変	
にっていや	日程→	名詞	
にちほ	日保	名詞	
にほんびそー	日本ビソー	名詞	
にほんげんねん	日本原燃	組織	
いりきり	入り切り	名詞	
いれるとき	入れる時	名詞	
にゅうきょか	入居可	名詞	
にゅうこうじ	入構時	名詞	
にゅうこうしゃ	入構者	名詞	
にゅうこうでき	入構出来	動詞一段	
にゅうこうしょう	入構証	名詞サ変	
にゅうこうちゅう	入構中	名詞	
にゅうじ	入時	名詞	
にゅうしゅか	入手可	名詞	
にゅうしゅでき	入手出来	動詞一段	
にゅうたいきょく	入退局	名詞	
にゅうたいこう	入退構	名詞	
にゅうとう	入棟	名詞	
にゅうりょくするや	入力する→	名詞	
にゅうりょくか	入力可	名詞	
にゅうりょくでき	入力出来	動詞一段	
にゅうりょくようと	入力用途	名詞	
にゅうりょくりょう	入力量	名詞	
ねんどまつから	年度末～	感動詞	
ゆき	之	名	
のういん	納院	名詞	
はあくすること	把握する事	名詞	
はさいとう	破砕等	名詞	
ぱい	廃	名詞	
はいえんびか	廃塩ビ化	名詞サ変	
はいきさき	廃棄先	名詞	
はいしとどけで	廃止届出	動詞一段	
はいきさき	排気先	名詞	
はいしゅつとう	排出等	名詞	
はいすいそうや	排水槽→	名詞	
はいいん	配員	接尾一般	
はいそうとう	配送等	名詞	
はいれつしよう	配列使用	名詞サ変	
かいとりでき	買取出来	動詞一段	
ばいち	売地	名詞	
はがれな	剥がれ無	形容詞	
はくりなど	剥離等	名詞	
ひろ	博	姓	
ひろ	博	名	
ひろまる	博○	名詞	
はくぶん	博文	名詞	
はくぶんかい	博文会	名詞	
しらいと	白井と	名詞サ変	
しらいし	白井氏	名詞	
しろいろや	白色→	名詞	
うすべにや	薄ベニヤ	名詞	
うすぬり	薄塗り	名詞サ変	
ほずみ	八月一日	姓	
はちまんたいら	八幡平	姓	
はちまんたいら	八幡平	地名	
はっけんなど	発見等	名詞	
はっせいするため	発生する為	名詞	
はっせいざい	発生材	名詞	
はっちゅうしゃ	発注社	名詞	
はっちゅうしゃめい	発注者名	名詞	
はつばん	発番	接尾一般	
はつばん	発番	助数詞	
はつばん	発番	名詞サ変	
ぬきさししき	抜き差し式	名詞	
ぬきだすや	抜き出す→	名詞	
はんしゅつや	搬出→	名詞	
ばんかん	版間	接尾一般	
はんすう	班数	接尾一般	
はんすう	班数	助数詞	
ぱん	販	名詞	
はんいや	範囲→	名詞	
はんいごと	範囲毎	名詞	
ばんごうじゅん	番号潤	名詞	
ばんせんとう	番線等	名詞	
ばんとう	盤等	接尾一般	
ひかくでき	比較出来	動詞一段	
ひりつ	費率	接尾一般	
ひりつ	費率	名詞	
つばさ	飛翔	名	
といした	樋下	名詞	
みいち	美一	名	
みこ	美子	名	
よしかつ	美勝	名	
ひつようや	必要→	名詞	
ひつようかなど	必要か等	名詞	
ひつような	必要無	形容詞	
ひの	桧野	姓	
ひょうを	表を	感動詞	
ひょうかぶ	表下部	名詞	
ひょうしよう	表紙用	名詞	
ひょうじでき	表示出来	動詞一段	
びょうとうや	病棟→	名詞	
ふそくど	不足土	名詞	
ふめいや	不明→	名詞	
ふぞくしゃ	付属舎	名詞	
しきならし	敷均し	名詞サ変	
しきならしず	敷均し図	名詞	
ふしつ	附室	名詞	
たけよし	武𠮷	姓	
ぶか	部か	名詞	
ぶつや	部艶	名詞	
ふせたに	伏谷	姓	
ふっきゅうしよう	復旧仕様	名詞	
ふくまる	福○	名詞	
ふくこう	福興	名詞	
ふくこうでんき	福興電気	名詞	
ふくでん	複電	名詞	
はら	払	名詞	
ぶっかばん	物価版	名詞	
ぶつりか	物理化	名詞サ変	
ふんや	分→	名詞	
わけなし	分け無し	名詞	
ぶつや	分艶	名詞	
ぶんかつや	分割→	名詞	
ぶんしよう	分使用	名詞サ変	
ぶんぞうか	分増加	名詞サ変	
ふんじんけい	粉じん計	名詞	
ききとりや	聞き取り→	名詞	
へいぶん	塀分	名詞	
ひらめん	平面	名詞	
えつき	柄付	名詞	
ならびかえよう	並び換え用	名詞	
よねや	米屋	姓	
へきそう	壁装	名詞	
へきそうさぎょう	壁装作業	名詞サ変	
かわったとき	変った時	名詞	
へんこうがい	変更外	名詞	
へんこうご	変更誤	接頭語	
へんしゅうでき	編集出来	動詞一段	
かえすよう	返す用	名詞	
へんかんまえや	返還前→	名詞	
へんきゃくや	返却→	名詞	
へんきゃくなど	返却等	名詞	
べんそう	便槽	名詞	
べんるい	弁類	名詞	
ほおんない	保温内	名詞	
ほかんじょう	保管場	名詞	
ほごますく	保護マスク	名詞サ変	
ほこう	保工	名詞	
ぽ	舗	名詞	
ほしょう	舗床	名詞	
ほかつ	歩活	名詞	
ほきょうなし	補強無し	名詞	
ほしょう	補床	名詞	
ほちょうきてん	補聴器店	名詞	
ぽう	報	名詞	
ほうこくや	報告→	名詞	
ほうこくしょや	報告書→	名詞	
ほうけんしゅ	奉献酒	名詞	
ほうかん	放管	名詞	
ほうしゃせんか	放射線課	名詞	
とものり	朋典	名	
ほういち	法一	名	
ぼうそう	坊草	名詞	
ぼうそうの	坊草の	名詞	
ぼうかざい	防火材	名詞	
きたや	北→	名詞	
ほっかいどうね	北海道ネ	地名	
きたとう	北棟	名詞	
すみだし	墨出し	名詞	
ほんみがき	本みがき	名詞	
もとうす	本臼	姓	
ほんおか	本岡	姓	
ほんおか	本岡	地名	
ほんこうじない	本工事内	名詞	
ぼんせん	本線	助数詞	
ぼんせん	本線	名詞	
ほんねんどや	本年度→	名詞	
うめもどしよう	埋め戻し用	名詞	
まいせつはいかん	埋設配管	名詞サ変	
せのう	妹尾	姓	
まいや	枚→	名詞	
まいよう	枚用	助数詞	
まいよう	枚用	名詞	
まくいたですみぶ	幕板出隅部	名詞	
ますのこ	桝残	動詞サ行五段	
まつづき	末月	接尾一般	
まつまえ	末前	接頭語	
まつばん	末番	接尾一般	
まつばん	末番	名詞サ変	
まつぶん	末分	接尾一般	
まつぶん	末分	名詞	
まんえん	万円	名詞サ変	
ばんのうばん	万能板	名詞	
みついし	満井氏	名詞	
みけっていや	未決定→	名詞	
みそう	未送	名詞	
みていや	未定→	名詞	
みのるや	稔也	名詞	
みんゆう	民友	名詞	
むしゃ	務者	名詞	
ゆめや	夢屋	名詞	
ないけん	無い件	名詞	
ないむね	無い旨	名詞	
ないたんか	無い単価	名詞	
なかったかなど	無かったか等	名詞	
むじんすい	無じん水	名詞	
むしや	無視→	名詞	
めいや	名→	名詞	
めいしーと	名シート	名詞	
めいい	名居	動詞一段	
めいしょうや	名称→	名詞	
めいとう	名等	接尾一般	
めいとう	名等	助数詞	
めいよう	名用	接尾一般	
めいよう	名用	助数詞	
めいよう	名用	名詞	
めいれい	名例	接尾一般	
めいれい	名例	助数詞	
めいれい	名例	名詞	
なわた	名和田	姓	
あさってごろ	明後日頃	名詞	
めいさん	明三	数	
めいしょう	明翔	名詞	
つらいち	面位置	名詞サ変	
めんず	面図	接尾一般	
めんず	面図	助数詞	
めんず	面図	名詞	
めんすう	面数	接尾一般	
めんすう	面数	助数詞	
めんだい	面台	接尾一般	
めんだい	面台	助数詞	
めんだい	面台	名詞	
めんだんひょう	面談表	名詞サ変	
もようがえご	模様替え後	接尾一般	
もようがえご	模様替え後	名詞	
もうない	毛内	名詞	
きのしたまこと	木下真	名詞	
きばらの	木原の	名詞	
きざら	木皿	名詞	
もくもうばん	木毛板	名詞	
きなみ	木浪	姓	
めいこう	目以降	名詞	
めじとも	目地共	名詞	
めばりなど	目張り等	名詞	
めちょう	目町	名詞	
もらうや	貰う→	名詞	
もんだいなしや	問題なし→	名詞	
のず	野津	姓	
のぶみ	野文	名詞	
ゆてい	油堤	接尾一般	
ゆうせんどや	優先度→	名詞	
ゆうた	優汰	名	
ゆうじろう	優二郎	名	
ゆうはちじま	優八島	名詞	
ゆうしょう	勇勝	名	
ともみ	友美	名詞	
ゆう	悠生	名	
ありや	有り→	名詞	
ゆたか	有孝	名	
ゆうき	祐輝	名	
ゆうめい	祐明	名	
ゆうどうしゃ	誘導車	名詞	
ゆうせいや	郵政→	名詞	
ゆうせいさま	郵政様	名詞	
おまる	雄○	名詞	
ゆうりょう	雄亮	名	
ゆうれい	夕礼	名詞サ変	
よそくけい	予測計	名詞	
よていしゃや	予定者→	名詞	
よびや	予備→	名詞	
さまに	様に	動詞一段	
ようせつめん	溶接面	名詞	
ようせる	用セル	名詞	
よういでき	用意出来	動詞一段	
ようきゅう	用旧	接頭語	
ようぎょう	用行	接尾一般	
ようぎょう	用行	助数詞	
ようぎょう	用行	名詞	
ようせいちゅうや	要請中→	名詞	
ようかい	陽会	名詞	
ようじょうや	養生→	名詞	
ようじょうしよう	養生仕様	名詞	
ようじょうず	養生図	名詞	
よくじょうとう	浴場棟	名詞	
よくげついこう	翌月以降	名詞	
きたかったため	来たかった為	名詞	
としひと	利仁	名	
りかい	理会	名詞	
たち	立	姓	
たちあいから	立会～	感動詞	
たちあいしゃ	立会者	名詞	
ながしばり	流し貼り	名詞サ変	
りゅうごう	流郷	姓	
りゅうじ	竜士	名	
はりごと	梁ごと	名詞	
はりした	梁下	名詞	
はりじょういどうじ	梁上移動時	名詞	
よいのかや	良いのか→	名詞	
りょうわ	良和	名詞	
りょうとう	量等	接尾一般	
りんかさま	隣家様	名詞	
りんちしよう	隣地使用	名詞サ変	
れいわ	令和	名詞	
れいすいきよう	冷水器用	名詞	
れいぞうことう	冷蔵庫等	名詞	
れいほう	嶺宝	名詞	
れいじ	礼時	名詞	
れつから	列～	感動詞	
れんけつち	連結値	名詞	
れんらくや	連絡→	名詞	
ろうばん	労番	名詞サ変	
ろうかした	廊下下	名詞	
なみえかいたい	浪江解体	名詞サ変	
なみえかいたいさぎょうしょ	浪江解体作業所	名詞	
ろっかしょむら	六カ所村	名詞	
かずよし	和佳	名	
わくや	枠→	名詞	
でんのう	傳農	姓	
りょうじ	凉二	名	
はつりこう	斫り工	名詞	
こうき	皓貴	接頭語	
れきそう	礫層	名詞	
しょうまる	翔○	名詞	
しょうわ	翔和	名詞	
あきたか	顯隆	名	
さき	﨑	姓	
よろ	よろしくお願いします	名詞	
もり	盛岡1ビル改修本体工事	名詞	
ばら	払	名詞	
